"","der_activity_month","type","speciality","procedure_desc_short","n_spells_IP","n_spells_OP","all_activity"
"1","2018-02-01","Independent Sector","Orthopaedic","Elbow","248","115","363"
"2","2018-02-01","Independent Sector","Orthopaedic","Foot","1854","364","2218"
"3","2018-02-01","Independent Sector","Orthopaedic","Hand","2288","344","2632"
"4","2018-02-01","Independent Sector","Orthopaedic","Hip","2684","217","2901"
"5","2018-02-01","Independent Sector","Orthopaedic","Knee","4830","712","5542"
"6","2018-02-01","Independent Sector","Orthopaedic","Shoulder","1625","483","2108"
"7","2018-02-01","NHS","Orthopaedic","Elbow","1181","3112","4293"
"8","2018-02-01","NHS","Orthopaedic","Foot","5591","2770","8361"
"9","2018-02-01","NHS","Orthopaedic","Hand","8137","5072","13209"
"10","2018-02-01","NHS","Orthopaedic","Hip","6218","1435","7653"
"11","2018-02-01","NHS","Orthopaedic","Knee","10316","4409","14725"
"12","2018-02-01","NHS","Orthopaedic","Shoulder","4039","3472","7511"
"13","2018-03-01","Independent Sector","Orthopaedic","Elbow","236","113","349"
"14","2018-03-01","Independent Sector","Orthopaedic","Foot","1811","368","2179"
"15","2018-03-01","Independent Sector","Orthopaedic","Hand","2366","328","2694"
"16","2018-03-01","Independent Sector","Orthopaedic","Hip","2824","197","3021"
"17","2018-03-01","Independent Sector","Orthopaedic","Knee","5128","699","5827"
"18","2018-03-01","Independent Sector","Orthopaedic","Shoulder","1779","545","2324"
"19","2018-03-01","NHS","Orthopaedic","Elbow","1246","3497","4743"
"20","2018-03-01","NHS","Orthopaedic","Foot","5789","2843","8632"
"21","2018-03-01","NHS","Orthopaedic","Hand","7951","5340","13291"
"22","2018-03-01","NHS","Orthopaedic","Hip","6719","1324","8043"
"23","2018-03-01","NHS","Orthopaedic","Knee","10741","4785","15526"
"24","2018-03-01","NHS","Orthopaedic","Shoulder","4349","3624","7973"
"25","2018-04-01","Independent Sector","Orthopaedic","Elbow","244","131","375"
"26","2018-04-01","Independent Sector","Orthopaedic","Foot","1668","359","2027"
"27","2018-04-01","Independent Sector","Orthopaedic","Hand","2160","363","2523"
"28","2018-04-01","Independent Sector","Orthopaedic","Hip","2580","210","2790"
"29","2018-04-01","Independent Sector","Orthopaedic","Knee","4488","765","5253"
"30","2018-04-01","Independent Sector","Orthopaedic","Shoulder","1601","533","2134"
"31","2018-04-01","NHS","Orthopaedic","Elbow","1174","4015","5189"
"32","2018-04-01","NHS","Orthopaedic","Foot","5673","3125","8798"
"33","2018-04-01","NHS","Orthopaedic","Hand","7922","5537","13459"
"34","2018-04-01","NHS","Orthopaedic","Hip","6763","1641","8404"
"35","2018-04-01","NHS","Orthopaedic","Knee","10778","5046","15824"
"36","2018-04-01","NHS","Orthopaedic","Shoulder","4153","4019","8172"
"37","2018-05-01","Independent Sector","Orthopaedic","Elbow","247","145","392"
"38","2018-05-01","Independent Sector","Orthopaedic","Foot","1607","428","2035"
"39","2018-05-01","Independent Sector","Orthopaedic","Hand","2265","416","2681"
"40","2018-05-01","Independent Sector","Orthopaedic","Hip","2696","241","2937"
"41","2018-05-01","Independent Sector","Orthopaedic","Knee","4574","758","5332"
"42","2018-05-01","Independent Sector","Orthopaedic","Shoulder","1667","558","2225"
"43","2018-05-01","NHS","Orthopaedic","Elbow","1282","4805","6087"
"44","2018-05-01","NHS","Orthopaedic","Foot","5914","3406","9320"
"45","2018-05-01","NHS","Orthopaedic","Hand","8286","6592","14878"
"46","2018-05-01","NHS","Orthopaedic","Hip","7665","1826","9491"
"47","2018-05-01","NHS","Orthopaedic","Knee","11960","5640","17600"
"48","2018-05-01","NHS","Orthopaedic","Shoulder","4612","4885","9497"
"49","2018-06-01","Independent Sector","Orthopaedic","Elbow","212","126","338"
"50","2018-06-01","Independent Sector","Orthopaedic","Foot","1582","354","1936"
"51","2018-06-01","Independent Sector","Orthopaedic","Hand","2239","358","2597"
"52","2018-06-01","Independent Sector","Orthopaedic","Hip","2692","243","2935"
"53","2018-06-01","Independent Sector","Orthopaedic","Knee","4461","774","5235"
"54","2018-06-01","Independent Sector","Orthopaedic","Shoulder","1510","552","2062"
"55","2018-06-01","NHS","Orthopaedic","Elbow","1265","5065","6330"
"56","2018-06-01","NHS","Orthopaedic","Foot","6117","3132","9249"
"57","2018-06-01","NHS","Orthopaedic","Hand","8042","6473","14515"
"58","2018-06-01","NHS","Orthopaedic","Hip","7563","1715","9278"
"59","2018-06-01","NHS","Orthopaedic","Knee","11635","5166","16801"
"60","2018-06-01","NHS","Orthopaedic","Shoulder","4151","5052","9203"
"61","2018-07-01","Independent Sector","Orthopaedic","Elbow","216","130","346"
"62","2018-07-01","Independent Sector","Orthopaedic","Foot","1574","369","1943"
"63","2018-07-01","Independent Sector","Orthopaedic","Hand","2222","418","2640"
"64","2018-07-01","Independent Sector","Orthopaedic","Hip","2710","261","2971"
"65","2018-07-01","Independent Sector","Orthopaedic","Knee","4399","737","5136"
"66","2018-07-01","Independent Sector","Orthopaedic","Shoulder","1503","547","2050"
"67","2018-07-01","NHS","Orthopaedic","Elbow","1275","5401","6676"
"68","2018-07-01","NHS","Orthopaedic","Foot","5786","3192","8978"
"69","2018-07-01","NHS","Orthopaedic","Hand","8236","6258","14494"
"70","2018-07-01","NHS","Orthopaedic","Hip","7762","1659","9421"
"71","2018-07-01","NHS","Orthopaedic","Knee","11671","5088","16759"
"72","2018-07-01","NHS","Orthopaedic","Shoulder","4437","5249","9686"
"73","2018-08-01","Independent Sector","Orthopaedic","Elbow","173","109","282"
"74","2018-08-01","Independent Sector","Orthopaedic","Foot","1529","407","1936"
"75","2018-08-01","Independent Sector","Orthopaedic","Hand","2196","376","2572"
"76","2018-08-01","Independent Sector","Orthopaedic","Hip","2550","282","2832"
"77","2018-08-01","Independent Sector","Orthopaedic","Knee","4260","830","5090"
"78","2018-08-01","Independent Sector","Orthopaedic","Shoulder","1353","480","1833"
"79","2018-08-01","NHS","Orthopaedic","Elbow","1230","4868","6098"
"80","2018-08-01","NHS","Orthopaedic","Foot","5747","3058","8805"
"81","2018-08-01","NHS","Orthopaedic","Hand","7751","5764","13515"
"82","2018-08-01","NHS","Orthopaedic","Hip","7107","1626","8733"
"83","2018-08-01","NHS","Orthopaedic","Knee","10805","4739","15544"
"84","2018-08-01","NHS","Orthopaedic","Shoulder","3951","4686","8637"
"85","2018-09-01","Independent Sector","Orthopaedic","Elbow","240","114","354"
"86","2018-09-01","Independent Sector","Orthopaedic","Foot","1619","391","2010"
"87","2018-09-01","Independent Sector","Orthopaedic","Hand","2319","371","2690"
"88","2018-09-01","Independent Sector","Orthopaedic","Hip","2869","253","3122"
"89","2018-09-01","Independent Sector","Orthopaedic","Knee","4600","736","5336"
"90","2018-09-01","Independent Sector","Orthopaedic","Shoulder","1492","516","2008"
"91","2018-09-01","NHS","Orthopaedic","Elbow","1232","4123","5355"
"92","2018-09-01","NHS","Orthopaedic","Foot","5634","2742","8376"
"93","2018-09-01","NHS","Orthopaedic","Hand","7688","5651","13339"
"94","2018-09-01","NHS","Orthopaedic","Hip","7061","1397","8458"
"95","2018-09-01","NHS","Orthopaedic","Knee","10688","4518","15206"
"96","2018-09-01","NHS","Orthopaedic","Shoulder","4131","4154","8285"
"97","2018-10-01","Independent Sector","Orthopaedic","Elbow","238","146","384"
"98","2018-10-01","Independent Sector","Orthopaedic","Foot","2038","432","2470"
"99","2018-10-01","Independent Sector","Orthopaedic","Hand","2479","406","2885"
"100","2018-10-01","Independent Sector","Orthopaedic","Hip","3030","283","3313"
"101","2018-10-01","Independent Sector","Orthopaedic","Knee","4876","832","5708"
"102","2018-10-01","Independent Sector","Orthopaedic","Shoulder","1537","598","2135"
"103","2018-10-01","NHS","Orthopaedic","Elbow","1370","4901","6271"
"104","2018-10-01","NHS","Orthopaedic","Foot","6611","3365","9976"
"105","2018-10-01","NHS","Orthopaedic","Hand","8757","6661","15418"
"106","2018-10-01","NHS","Orthopaedic","Hip","8046","1639","9685"
"107","2018-10-01","NHS","Orthopaedic","Knee","12554","5484","18038"
"108","2018-10-01","NHS","Orthopaedic","Shoulder","4725","4795","9520"
"109","2018-11-01","Independent Sector","Orthopaedic","Elbow","268","124","392"
"110","2018-11-01","Independent Sector","Orthopaedic","Foot","1915","449","2364"
"111","2018-11-01","Independent Sector","Orthopaedic","Hand","2396","424","2820"
"112","2018-11-01","Independent Sector","Orthopaedic","Hip","3142","272","3414"
"113","2018-11-01","Independent Sector","Orthopaedic","Knee","5042","763","5805"
"114","2018-11-01","Independent Sector","Orthopaedic","Shoulder","1650","499","2149"
"115","2018-11-01","NHS","Orthopaedic","Elbow","1380","4549","5929"
"116","2018-11-01","NHS","Orthopaedic","Foot","6348","3092","9440"
"117","2018-11-01","NHS","Orthopaedic","Hand","9103","5820","14923"
"118","2018-11-01","NHS","Orthopaedic","Hip","8219","1524","9743"
"119","2018-11-01","NHS","Orthopaedic","Knee","12632","5162","17794"
"120","2018-11-01","NHS","Orthopaedic","Shoulder","4792","4252","9044"
"121","2018-12-01","Independent Sector","Orthopaedic","Elbow","193","112","305"
"122","2018-12-01","Independent Sector","Orthopaedic","Foot","1499","321","1820"
"123","2018-12-01","Independent Sector","Orthopaedic","Hand","1773","288","2061"
"124","2018-12-01","Independent Sector","Orthopaedic","Hip","2542","206","2748"
"125","2018-12-01","Independent Sector","Orthopaedic","Knee","4118","596","4714"
"126","2018-12-01","Independent Sector","Orthopaedic","Shoulder","1207","419","1626"
"127","2018-12-01","NHS","Orthopaedic","Elbow","1030","3969","4999"
"128","2018-12-01","NHS","Orthopaedic","Foot","5037","2442","7479"
"129","2018-12-01","NHS","Orthopaedic","Hand","7063","4846","11909"
"130","2018-12-01","NHS","Orthopaedic","Hip","6880","1342","8222"
"131","2018-12-01","NHS","Orthopaedic","Knee","10370","4345","14715"
"132","2018-12-01","NHS","Orthopaedic","Shoulder","3646","3282","6928"
"133","2019-01-01","Independent Sector","Orthopaedic","Elbow","245","116","361"
"134","2019-01-01","Independent Sector","Orthopaedic","Foot","1925","482","2407"
"135","2019-01-01","Independent Sector","Orthopaedic","Hand","2338","352","2690"
"136","2019-01-01","Independent Sector","Orthopaedic","Hip","2754","262","3016"
"137","2019-01-01","Independent Sector","Orthopaedic","Knee","4834","752","5586"
"138","2019-01-01","Independent Sector","Orthopaedic","Shoulder","1494","547","2041"
"139","2019-01-01","NHS","Orthopaedic","Elbow","1210","4495","5705"
"140","2019-01-01","NHS","Orthopaedic","Foot","6331","3097","9428"
"141","2019-01-01","NHS","Orthopaedic","Hand","8639","5814","14453"
"142","2019-01-01","NHS","Orthopaedic","Hip","6682","1583","8265"
"143","2019-01-01","NHS","Orthopaedic","Knee","10699","5193","15892"
"144","2019-01-01","NHS","Orthopaedic","Shoulder","4313","4025","8338"
"145","2019-02-01","Independent Sector","Orthopaedic","Elbow","215","94","309"
"146","2019-02-01","Independent Sector","Orthopaedic","Foot","1819","366","2185"
"147","2019-02-01","Independent Sector","Orthopaedic","Hand","2206","345","2551"
"148","2019-02-01","Independent Sector","Orthopaedic","Hip","2746","226","2972"
"149","2019-02-01","Independent Sector","Orthopaedic","Knee","4628","764","5392"
"150","2019-02-01","Independent Sector","Orthopaedic","Shoulder","1450","480","1930"
"151","2019-02-01","NHS","Orthopaedic","Elbow","1118","3920","5038"
"152","2019-02-01","NHS","Orthopaedic","Foot","5689","2627","8316"
"153","2019-02-01","NHS","Orthopaedic","Hand","7664","5230","12894"
"154","2019-02-01","NHS","Orthopaedic","Hip","6759","1460","8219"
"155","2019-02-01","NHS","Orthopaedic","Knee","10486","4503","14989"
"156","2019-02-01","NHS","Orthopaedic","Shoulder","3910","3741","7651"
"157","2019-03-01","Independent Sector","Orthopaedic","Elbow","279","99","378"
"158","2019-03-01","Independent Sector","Orthopaedic","Foot","1896","437","2333"
"159","2019-03-01","Independent Sector","Orthopaedic","Hand","2279","312","2591"
"160","2019-03-01","Independent Sector","Orthopaedic","Hip","3107","206","3313"
"161","2019-03-01","Independent Sector","Orthopaedic","Knee","5162","740","5902"
"162","2019-03-01","Independent Sector","Orthopaedic","Shoulder","1616","497","2113"
"163","2019-03-01","NHS","Orthopaedic","Elbow","1169","4176","5345"
"164","2019-03-01","NHS","Orthopaedic","Foot","6031","2818","8849"
"165","2019-03-01","NHS","Orthopaedic","Hand","8448","5802","14250"
"166","2019-03-01","NHS","Orthopaedic","Hip","7587","1566","9153"
"167","2019-03-01","NHS","Orthopaedic","Knee","11793","4751","16544"
"168","2019-03-01","NHS","Orthopaedic","Shoulder","4271","4080","8351"
"169","2019-04-01","Independent Sector","Orthopaedic","Elbow","264","114","378"
"170","2019-04-01","Independent Sector","Orthopaedic","Foot","1515","367","1882"
"171","2019-04-01","Independent Sector","Orthopaedic","Hand","1935","331","2266"
"172","2019-04-01","Independent Sector","Orthopaedic","Hip","2417","240","2657"
"173","2019-04-01","Independent Sector","Orthopaedic","Knee","4147","706","4853"
"174","2019-04-01","Independent Sector","Orthopaedic","Shoulder","1275","454","1729"
"175","2019-04-01","NHS","Orthopaedic","Elbow","1390","4613","6003"
"176","2019-04-01","NHS","Orthopaedic","Foot","5773","2965","8738"
"177","2019-04-01","NHS","Orthopaedic","Hand","7672","5941","13613"
"178","2019-04-01","NHS","Orthopaedic","Hip","6806","1543","8349"
"179","2019-04-01","NHS","Orthopaedic","Knee","10725","5070","15795"
"180","2019-04-01","NHS","Orthopaedic","Shoulder","3522","4405","7927"
"181","2019-05-01","Independent Sector","Orthopaedic","Elbow","321","115","436"
"182","2019-05-01","Independent Sector","Orthopaedic","Foot","1636","368","2004"
"183","2019-05-01","Independent Sector","Orthopaedic","Hand","2301","393","2694"
"184","2019-05-01","Independent Sector","Orthopaedic","Hip","2855","215","3070"
"185","2019-05-01","Independent Sector","Orthopaedic","Knee","4654","805","5459"
"186","2019-05-01","Independent Sector","Orthopaedic","Shoulder","1377","481","1858"
"187","2019-05-01","NHS","Orthopaedic","Elbow","1449","5135","6584"
"188","2019-05-01","NHS","Orthopaedic","Foot","6007","3098","9105"
"189","2019-05-01","NHS","Orthopaedic","Hand","8063","6532","14595"
"190","2019-05-01","NHS","Orthopaedic","Hip","7553","1682","9235"
"191","2019-05-01","NHS","Orthopaedic","Knee","11252","5335","16587"
"192","2019-05-01","NHS","Orthopaedic","Shoulder","3838","4658","8496"
"193","2019-06-01","Independent Sector","Orthopaedic","Elbow","266","103","369"
"194","2019-06-01","Independent Sector","Orthopaedic","Foot","1499","377","1876"
"195","2019-06-01","Independent Sector","Orthopaedic","Hand","2083","339","2422"
"196","2019-06-01","Independent Sector","Orthopaedic","Hip","2899","202","3101"
"197","2019-06-01","Independent Sector","Orthopaedic","Knee","4540","811","5351"
"198","2019-06-01","Independent Sector","Orthopaedic","Shoulder","1313","473","1786"
"199","2019-06-01","NHS","Orthopaedic","Elbow","1294","5187","6481"
"200","2019-06-01","NHS","Orthopaedic","Foot","5712","2891","8603"
"201","2019-06-01","NHS","Orthopaedic","Hand","7615","6059","13674"
"202","2019-06-01","NHS","Orthopaedic","Hip","7423","1603","9026"
"203","2019-06-01","NHS","Orthopaedic","Knee","10909","5029","15938"
"204","2019-06-01","NHS","Orthopaedic","Shoulder","3548","4602","8150"
"205","2019-07-01","Independent Sector","Orthopaedic","Elbow","281","107","388"
"206","2019-07-01","Independent Sector","Orthopaedic","Foot","1640","418","2058"
"207","2019-07-01","Independent Sector","Orthopaedic","Hand","2232","388","2620"
"208","2019-07-01","Independent Sector","Orthopaedic","Hip","2827","270","3097"
"209","2019-07-01","Independent Sector","Orthopaedic","Knee","4588","821","5409"
"210","2019-07-01","Independent Sector","Orthopaedic","Shoulder","1313","478","1791"
"211","2019-07-01","NHS","Orthopaedic","Elbow","1540","6216","7756"
"212","2019-07-01","NHS","Orthopaedic","Foot","5984","3372","9356"
"213","2019-07-01","NHS","Orthopaedic","Hand","8547","7044","15591"
"214","2019-07-01","NHS","Orthopaedic","Hip","7452","1905","9357"
"215","2019-07-01","NHS","Orthopaedic","Knee","11364","5463","16827"
"216","2019-07-01","NHS","Orthopaedic","Shoulder","3970","5472","9442"
"217","2019-08-01","Independent Sector","Orthopaedic","Elbow","261","163","424"
"218","2019-08-01","Independent Sector","Orthopaedic","Foot","1507","391","1898"
"219","2019-08-01","Independent Sector","Orthopaedic","Hand","2167","372","2539"
"220","2019-08-01","Independent Sector","Orthopaedic","Hip","2727","222","2949"
"221","2019-08-01","Independent Sector","Orthopaedic","Knee","4063","788","4851"
"222","2019-08-01","Independent Sector","Orthopaedic","Shoulder","1223","460","1683"
"223","2019-08-01","NHS","Orthopaedic","Elbow","1377","5131","6508"
"224","2019-08-01","NHS","Orthopaedic","Foot","5278","2969","8247"
"225","2019-08-01","NHS","Orthopaedic","Hand","7118","5628","12746"
"226","2019-08-01","NHS","Orthopaedic","Hip","6769","1646","8415"
"227","2019-08-01","NHS","Orthopaedic","Knee","9885","4707","14592"
"228","2019-08-01","NHS","Orthopaedic","Shoulder","3369","4567","7936"
"229","2019-09-01","Independent Sector","Orthopaedic","Elbow","282","258","540"
"230","2019-09-01","Independent Sector","Orthopaedic","Foot","1650","421","2071"
"231","2019-09-01","Independent Sector","Orthopaedic","Hand","2142","450","2592"
"232","2019-09-01","Independent Sector","Orthopaedic","Hip","2795","260","3055"
"233","2019-09-01","Independent Sector","Orthopaedic","Knee","4566","846","5412"
"234","2019-09-01","Independent Sector","Orthopaedic","Shoulder","1304","480","1784"
"235","2019-09-01","NHS","Orthopaedic","Elbow","1621","5011","6632"
"236","2019-09-01","NHS","Orthopaedic","Foot","5790","3069","8859"
"237","2019-09-01","NHS","Orthopaedic","Hand","7803","6212","14015"
"238","2019-09-01","NHS","Orthopaedic","Hip","6938","1846","8784"
"239","2019-09-01","NHS","Orthopaedic","Knee","10836","4944","15780"
"240","2019-09-01","NHS","Orthopaedic","Shoulder","3780","4710","8490"
"241","2019-10-01","Independent Sector","Orthopaedic","Elbow","283","243","526"
"242","2019-10-01","Independent Sector","Orthopaedic","Foot","1927","457","2384"
"243","2019-10-01","Independent Sector","Orthopaedic","Hand","2267","512","2779"
"244","2019-10-01","Independent Sector","Orthopaedic","Hip","3034","238","3272"
"245","2019-10-01","Independent Sector","Orthopaedic","Knee","5016","890","5906"
"246","2019-10-01","Independent Sector","Orthopaedic","Shoulder","1497","576","2073"
"247","2019-10-01","NHS","Orthopaedic","Elbow","1680","5363","7043"
"248","2019-10-01","NHS","Orthopaedic","Foot","6350","3254","9604"
"249","2019-10-01","NHS","Orthopaedic","Hand","8949","6741","15690"
"250","2019-10-01","NHS","Orthopaedic","Hip","7843","1929","9772"
"251","2019-10-01","NHS","Orthopaedic","Knee","12054","5452","17506"
"252","2019-10-01","NHS","Orthopaedic","Shoulder","4155","4761","8916"
"253","2019-11-01","Independent Sector","Orthopaedic","Elbow","302","201","503"
"254","2019-11-01","Independent Sector","Orthopaedic","Foot","1767","418","2185"
"255","2019-11-01","Independent Sector","Orthopaedic","Hand","2400","461","2861"
"256","2019-11-01","Independent Sector","Orthopaedic","Hip","3039","236","3275"
"257","2019-11-01","Independent Sector","Orthopaedic","Knee","4979","840","5819"
"258","2019-11-01","Independent Sector","Orthopaedic","Shoulder","1437","491","1928"
"259","2019-11-01","NHS","Orthopaedic","Elbow","1461","4256","5717"
"260","2019-11-01","NHS","Orthopaedic","Foot","5893","2885","8778"
"261","2019-11-01","NHS","Orthopaedic","Hand","8196","5752","13948"
"262","2019-11-01","NHS","Orthopaedic","Hip","7486","1676","9162"
"263","2019-11-01","NHS","Orthopaedic","Knee","10953","4841","15794"
"264","2019-11-01","NHS","Orthopaedic","Shoulder","3895","3789","7684"
"265","2019-12-01","Independent Sector","Orthopaedic","Elbow","232","203","435"
"266","2019-12-01","Independent Sector","Orthopaedic","Foot","1355","397","1752"
"267","2019-12-01","Independent Sector","Orthopaedic","Hand","1835","369","2204"
"268","2019-12-01","Independent Sector","Orthopaedic","Hip","2371","177","2548"
"269","2019-12-01","Independent Sector","Orthopaedic","Knee","3952","701","4653"
"270","2019-12-01","Independent Sector","Orthopaedic","Shoulder","1077","449","1526"
"271","2019-12-01","NHS","Orthopaedic","Elbow","1248","4244","5492"
"272","2019-12-01","NHS","Orthopaedic","Foot","4864","2526","7390"
"273","2019-12-01","NHS","Orthopaedic","Hand","6676","5297","11973"
"274","2019-12-01","NHS","Orthopaedic","Hip","6259","1552","7811"
"275","2019-12-01","NHS","Orthopaedic","Knee","9556","4419","13975"
"276","2019-12-01","NHS","Orthopaedic","Shoulder","3187","3514","6701"
"277","2020-01-01","Independent Sector","Orthopaedic","Elbow","306","241","547"
"278","2020-01-01","Independent Sector","Orthopaedic","Foot","1900","414","2314"
"279","2020-01-01","Independent Sector","Orthopaedic","Hand","2365","456","2821"
"280","2020-01-01","Independent Sector","Orthopaedic","Hip","2803","274","3077"
"281","2020-01-01","Independent Sector","Orthopaedic","Knee","4880","903","5783"
"282","2020-01-01","Independent Sector","Orthopaedic","Shoulder","1335","538","1873"
"283","2020-01-01","NHS","Orthopaedic","Elbow","1486","4390","5876"
"284","2020-01-01","NHS","Orthopaedic","Foot","6069","2977","9046"
"285","2020-01-01","NHS","Orthopaedic","Hand","8725","5852","14577"
"286","2020-01-01","NHS","Orthopaedic","Hip","6439","1879","8318"
"287","2020-01-01","NHS","Orthopaedic","Knee","10033","4991","15024"
"288","2020-01-01","NHS","Orthopaedic","Shoulder","3796","3898","7694"
"289","2020-02-01","Independent Sector","Orthopaedic","Elbow","289","193","482"
"290","2020-02-01","Independent Sector","Orthopaedic","Foot","1754","341","2095"
"291","2020-02-01","Independent Sector","Orthopaedic","Hand","2174","410","2584"
"292","2020-02-01","Independent Sector","Orthopaedic","Hip","2867","219","3086"
"293","2020-02-01","Independent Sector","Orthopaedic","Knee","4747","803","5550"
"294","2020-02-01","Independent Sector","Orthopaedic","Shoulder","1291","459","1750"
"295","2020-02-01","NHS","Orthopaedic","Elbow","1365","3704","5069"
"296","2020-02-01","NHS","Orthopaedic","Foot","5712","2515","8227"
"297","2020-02-01","NHS","Orthopaedic","Hand","7878","5063","12941"
"298","2020-02-01","NHS","Orthopaedic","Hip","6821","1587","8408"
"299","2020-02-01","NHS","Orthopaedic","Knee","10466","4131","14597"
"300","2020-02-01","NHS","Orthopaedic","Shoulder","3557","3366","6923"
"301","2020-03-01","Independent Sector","Orthopaedic","Elbow","186","133","319"
"302","2020-03-01","Independent Sector","Orthopaedic","Foot","1146","247","1393"
"303","2020-03-01","Independent Sector","Orthopaedic","Hand","1562","300","1862"
"304","2020-03-01","Independent Sector","Orthopaedic","Hip","2166","138","2304"
"305","2020-03-01","Independent Sector","Orthopaedic","Knee","3599","533","4132"
"306","2020-03-01","Independent Sector","Orthopaedic","Shoulder","955","302","1257"
"307","2020-03-01","NHS","Orthopaedic","Elbow","854","3453","4307"
"308","2020-03-01","NHS","Orthopaedic","Foot","3271","2057","5328"
"309","2020-03-01","NHS","Orthopaedic","Hand","4788","4486","9274"
"310","2020-03-01","NHS","Orthopaedic","Hip","4568","1326","5894"
"311","2020-03-01","NHS","Orthopaedic","Knee","7109","3450","10559"
"312","2020-03-01","NHS","Orthopaedic","Shoulder","2326","2612","4938"
"313","2020-04-01","Independent Sector","Orthopaedic","Elbow","3","37","40"
"314","2020-04-01","Independent Sector","Orthopaedic","Foot","23","30","53"
"315","2020-04-01","Independent Sector","Orthopaedic","Hand","23","26","49"
"316","2020-04-01","Independent Sector","Orthopaedic","Hip","17","3","20"
"317","2020-04-01","Independent Sector","Orthopaedic","Knee","46","36","82"
"318","2020-04-01","Independent Sector","Orthopaedic","Shoulder","12","10","22"
"319","2020-04-01","NHS","Orthopaedic","Elbow","82","1906","1988"
"320","2020-04-01","NHS","Orthopaedic","Foot","134","874","1008"
"321","2020-04-01","NHS","Orthopaedic","Hand","236","1689","1925"
"322","2020-04-01","NHS","Orthopaedic","Hip","135","666","801"
"323","2020-04-01","NHS","Orthopaedic","Knee","264","1517","1781"
"324","2020-04-01","NHS","Orthopaedic","Shoulder","77","1418","1495"
"325","2020-05-01","Independent Sector","Orthopaedic","Elbow","9","42","51"
"326","2020-05-01","Independent Sector","Orthopaedic","Foot","20","11","31"
"327","2020-05-01","Independent Sector","Orthopaedic","Hand","111","35","146"
"328","2020-05-01","Independent Sector","Orthopaedic","Hip","14","7","21"
"329","2020-05-01","Independent Sector","Orthopaedic","Knee","41","31","72"
"330","2020-05-01","Independent Sector","Orthopaedic","Shoulder","13","12","25"
"331","2020-05-01","NHS","Orthopaedic","Elbow","105","1974","2079"
"332","2020-05-01","NHS","Orthopaedic","Foot","217","789","1006"
"333","2020-05-01","NHS","Orthopaedic","Hand","490","1736","2226"
"334","2020-05-01","NHS","Orthopaedic","Hip","214","589","803"
"335","2020-05-01","NHS","Orthopaedic","Knee","435","1529","1964"
"336","2020-05-01","NHS","Orthopaedic","Shoulder","111","1528","1639"
"337","2020-06-01","Independent Sector","Orthopaedic","Elbow","40","56","96"
"338","2020-06-01","Independent Sector","Orthopaedic","Foot","137","14","151"
"339","2020-06-01","Independent Sector","Orthopaedic","Hand","283","57","340"
"340","2020-06-01","Independent Sector","Orthopaedic","Hip","161","10","171"
"341","2020-06-01","Independent Sector","Orthopaedic","Knee","376","58","434"
"342","2020-06-01","Independent Sector","Orthopaedic","Shoulder","145","31","176"
"343","2020-06-01","NHS","Orthopaedic","Elbow","353","2866","3219"
"344","2020-06-01","NHS","Orthopaedic","Foot","646","1239","1885"
"345","2020-06-01","NHS","Orthopaedic","Hand","1638","2823","4461"
"346","2020-06-01","NHS","Orthopaedic","Hip","790","819","1609"
"347","2020-06-01","NHS","Orthopaedic","Knee","1518","2077","3595"
"348","2020-06-01","NHS","Orthopaedic","Shoulder","554","2185","2739"
"349","2020-07-01","Independent Sector","Orthopaedic","Elbow","61","68","129"
"350","2020-07-01","Independent Sector","Orthopaedic","Foot","330","68","398"
"351","2020-07-01","Independent Sector","Orthopaedic","Hand","627","89","716"
"352","2020-07-01","Independent Sector","Orthopaedic","Hip","479","77","556"
"353","2020-07-01","Independent Sector","Orthopaedic","Knee","899","162","1061"
"354","2020-07-01","Independent Sector","Orthopaedic","Shoulder","330","108","438"
"355","2020-07-01","NHS","Orthopaedic","Elbow","560","3565","4125"
"356","2020-07-01","NHS","Orthopaedic","Foot","1676","1408","3084"
"357","2020-07-01","NHS","Orthopaedic","Hand","3292","3395","6687"
"358","2020-07-01","NHS","Orthopaedic","Hip","1995","942","2937"
"359","2020-07-01","NHS","Orthopaedic","Knee","3619","2518","6137"
"360","2020-07-01","NHS","Orthopaedic","Shoulder","1398","2546","3944"
"361","2020-08-01","Independent Sector","Orthopaedic","Elbow","115","68","183"
"362","2020-08-01","Independent Sector","Orthopaedic","Foot","502","70","572"
"363","2020-08-01","Independent Sector","Orthopaedic","Hand","800","128","928"
"364","2020-08-01","Independent Sector","Orthopaedic","Hip","1087","74","1161"
"365","2020-08-01","Independent Sector","Orthopaedic","Knee","1635","272","1907"
"366","2020-08-01","Independent Sector","Orthopaedic","Shoulder","442","126","568"
"367","2020-08-01","NHS","Orthopaedic","Elbow","727","3636","4363"
"368","2020-08-01","NHS","Orthopaedic","Foot","2390","1468","3858"
"369","2020-08-01","NHS","Orthopaedic","Hand","3436","3177","6613"
"370","2020-08-01","NHS","Orthopaedic","Hip","3250","1036","4286"
"371","2020-08-01","NHS","Orthopaedic","Knee","4865","2606","7471"
"372","2020-08-01","NHS","Orthopaedic","Shoulder","1697","2723","4420"
"373","2020-09-01","Independent Sector","Orthopaedic","Elbow","150","120","270"
"374","2020-09-01","Independent Sector","Orthopaedic","Foot","749","131","880"
"375","2020-09-01","Independent Sector","Orthopaedic","Hand","1338","209","1547"
"376","2020-09-01","Independent Sector","Orthopaedic","Hip","1401","112","1513"
"377","2020-09-01","Independent Sector","Orthopaedic","Knee","2322","387","2709"
"378","2020-09-01","Independent Sector","Orthopaedic","Shoulder","731","220","951"
"379","2020-09-01","NHS","Orthopaedic","Elbow","957","4378","5335"
"380","2020-09-01","NHS","Orthopaedic","Foot","3333","1842","5175"
"381","2020-09-01","NHS","Orthopaedic","Hand","5354","4211","9565"
"382","2020-09-01","NHS","Orthopaedic","Hip","4498","1361","5859"
"383","2020-09-01","NHS","Orthopaedic","Knee","6697","3245","9942"
"384","2020-09-01","NHS","Orthopaedic","Shoulder","2388","3336","5724"
"385","2020-10-01","Independent Sector","Orthopaedic","Elbow","195","123","318"
"386","2020-10-01","Independent Sector","Orthopaedic","Foot","1067","144","1211"
"387","2020-10-01","Independent Sector","Orthopaedic","Hand","1624","282","1906"
"388","2020-10-01","Independent Sector","Orthopaedic","Hip","2034","123","2157"
"389","2020-10-01","Independent Sector","Orthopaedic","Knee","3024","443","3467"
"390","2020-10-01","Independent Sector","Orthopaedic","Shoulder","889","290","1179"
"391","2020-10-01","NHS","Orthopaedic","Elbow","1168","3901","5069"
"392","2020-10-01","NHS","Orthopaedic","Foot","4034","1915","5949"
"393","2020-10-01","NHS","Orthopaedic","Hand","5949","4105","10054"
"394","2020-10-01","NHS","Orthopaedic","Hip","5641","1204","6845"
"395","2020-10-01","NHS","Orthopaedic","Knee","8276","3293","11569"
"396","2020-10-01","NHS","Orthopaedic","Shoulder","2616","2984","5600"
"397","2020-11-01","Independent Sector","Orthopaedic","Elbow","194","80","274"
"398","2020-11-01","Independent Sector","Orthopaedic","Foot","1010","174","1184"
"399","2020-11-01","Independent Sector","Orthopaedic","Hand","1544","247","1791"
"400","2020-11-01","Independent Sector","Orthopaedic","Hip","1914","139","2053"
"401","2020-11-01","Independent Sector","Orthopaedic","Knee","3026","434","3460"
"402","2020-11-01","Independent Sector","Orthopaedic","Shoulder","835","293","1128"
"403","2020-11-01","NHS","Orthopaedic","Elbow","1026","3153","4179"
"404","2020-11-01","NHS","Orthopaedic","Foot","3734","1770","5504"
"405","2020-11-01","NHS","Orthopaedic","Hand","5425","3414","8839"
"406","2020-11-01","NHS","Orthopaedic","Hip","5078","1125","6203"
"407","2020-11-01","NHS","Orthopaedic","Knee","7192","3093","10285"
"408","2020-11-01","NHS","Orthopaedic","Shoulder","2370","2648","5018"
"409","2020-12-01","Independent Sector","Orthopaedic","Elbow","162","99","261"
"410","2020-12-01","Independent Sector","Orthopaedic","Foot","832","147","979"
"411","2020-12-01","Independent Sector","Orthopaedic","Hand","1363","231","1594"
"412","2020-12-01","Independent Sector","Orthopaedic","Hip","1518","125","1643"
"413","2020-12-01","Independent Sector","Orthopaedic","Knee","2461","375","2836"
"414","2020-12-01","Independent Sector","Orthopaedic","Shoulder","790","278","1068"
"415","2020-12-01","NHS","Orthopaedic","Elbow","903","2804","3707"
"416","2020-12-01","NHS","Orthopaedic","Foot","2994","1532","4526"
"417","2020-12-01","NHS","Orthopaedic","Hand","4483","2919","7402"
"418","2020-12-01","NHS","Orthopaedic","Hip","4117","1139","5256"
"419","2020-12-01","NHS","Orthopaedic","Knee","5884","2823","8707"
"420","2020-12-01","NHS","Orthopaedic","Shoulder","1971","2363","4334"
"421","2021-01-01","Independent Sector","Orthopaedic","Elbow","177","59","236"
"422","2021-01-01","Independent Sector","Orthopaedic","Foot","961","144","1105"
"423","2021-01-01","Independent Sector","Orthopaedic","Hand","1706","224","1930"
"424","2021-01-01","Independent Sector","Orthopaedic","Hip","1640","96","1736"
"425","2021-01-01","Independent Sector","Orthopaedic","Knee","2769","329","3098"
"426","2021-01-01","Independent Sector","Orthopaedic","Shoulder","810","235","1045"
"427","2021-01-01","NHS","Orthopaedic","Elbow","405","2828","3233"
"428","2021-01-01","NHS","Orthopaedic","Foot","1215","1200","2415"
"429","2021-01-01","NHS","Orthopaedic","Hand","2184","2569","4753"
"430","2021-01-01","NHS","Orthopaedic","Hip","1523","965","2488"
"431","2021-01-01","NHS","Orthopaedic","Knee","2110","2339","4449"
"432","2021-01-01","NHS","Orthopaedic","Shoulder","783","1875","2658"
"433","2021-02-01","Independent Sector","Orthopaedic","Elbow","203","61","264"
"434","2021-02-01","Independent Sector","Orthopaedic","Foot","994","133","1127"
"435","2021-02-01","Independent Sector","Orthopaedic","Hand","1970","283","2253"
"436","2021-02-01","Independent Sector","Orthopaedic","Hip","1871","109","1980"
"437","2021-02-01","Independent Sector","Orthopaedic","Knee","3077","359","3436"
"438","2021-02-01","Independent Sector","Orthopaedic","Shoulder","961","252","1213"
"439","2021-02-01","NHS","Orthopaedic","Elbow","445","2836","3281"
"440","2021-02-01","NHS","Orthopaedic","Foot","1149","1272","2421"
"441","2021-02-01","NHS","Orthopaedic","Hand","2372","2700","5072"
"442","2021-02-01","NHS","Orthopaedic","Hip","1503","972","2475"
"443","2021-02-01","NHS","Orthopaedic","Knee","2083","2340","4423"
"444","2021-02-01","NHS","Orthopaedic","Shoulder","865","1895","2760"
"445","2021-03-01","Independent Sector","Orthopaedic","Elbow","292","77","369"
"446","2021-03-01","Independent Sector","Orthopaedic","Foot","1294","186","1480"
"447","2021-03-01","Independent Sector","Orthopaedic","Hand","2238","337","2575"
"448","2021-03-01","Independent Sector","Orthopaedic","Hip","2322","155","2477"
"449","2021-03-01","Independent Sector","Orthopaedic","Knee","4128","439","4567"
"450","2021-03-01","Independent Sector","Orthopaedic","Shoulder","1220","347","1567"
"451","2021-03-01","NHS","Orthopaedic","Elbow","804","3521","4325"
"452","2021-03-01","NHS","Orthopaedic","Foot","2420","1705","4125"
"453","2021-03-01","NHS","Orthopaedic","Hand","4221","3536","7757"
"454","2021-03-01","NHS","Orthopaedic","Hip","3168","1348","4516"
"455","2021-03-01","NHS","Orthopaedic","Knee","4745","2961","7706"
"456","2021-03-01","NHS","Orthopaedic","Shoulder","1684","2647","4331"
"457","2021-04-01","Independent Sector","Orthopaedic","Elbow","223","139","362"
"458","2021-04-01","Independent Sector","Orthopaedic","Foot","1316","194","1510"
"459","2021-04-01","Independent Sector","Orthopaedic","Hand","1812","323","2135"
"460","2021-04-01","Independent Sector","Orthopaedic","Hip","2417","162","2579"
"461","2021-04-01","Independent Sector","Orthopaedic","Knee","3871","440","4311"
"462","2021-04-01","Independent Sector","Orthopaedic","Shoulder","1078","313","1391"
"463","2021-04-01","NHS","Orthopaedic","Elbow","965","3572","4537"
"464","2021-04-01","NHS","Orthopaedic","Foot","3506","1888","5394"
"465","2021-04-01","NHS","Orthopaedic","Hand","4937","3665","8602"
"466","2021-04-01","NHS","Orthopaedic","Hip","4510","1432","5942"
"467","2021-04-01","NHS","Orthopaedic","Knee","6924","3158","10082"
"468","2021-04-01","NHS","Orthopaedic","Shoulder","2147","3139","5286"
"469","2021-05-01","Independent Sector","Orthopaedic","Elbow","242","166","408"
"470","2021-05-01","Independent Sector","Orthopaedic","Foot","1275","189","1464"
"471","2021-05-01","Independent Sector","Orthopaedic","Hand","1859","314","2173"
"472","2021-05-01","Independent Sector","Orthopaedic","Hip","2608","171","2779"
"473","2021-05-01","Independent Sector","Orthopaedic","Knee","4009","552","4561"
"474","2021-05-01","Independent Sector","Orthopaedic","Shoulder","1094","358","1452"
"475","2021-05-01","NHS","Orthopaedic","Elbow","1121","3614","4735"
"476","2021-05-01","NHS","Orthopaedic","Foot","4102","1899","6001"
"477","2021-05-01","NHS","Orthopaedic","Hand","6014","3985","9999"
"478","2021-05-01","NHS","Orthopaedic","Hip","6100","1507","7607"
"479","2021-05-01","NHS","Orthopaedic","Knee","8191","3224","11415"
"480","2021-05-01","NHS","Orthopaedic","Shoulder","2699","3176","5875"
"481","2021-06-01","Independent Sector","Orthopaedic","Elbow","207","178","385"
"482","2021-06-01","Independent Sector","Orthopaedic","Foot","1370","228","1598"
"483","2021-06-01","Independent Sector","Orthopaedic","Hand","1930","371","2301"
"484","2021-06-01","Independent Sector","Orthopaedic","Hip","2557","177","2734"
"485","2021-06-01","Independent Sector","Orthopaedic","Knee","3855","652","4507"
"486","2021-06-01","Independent Sector","Orthopaedic","Shoulder","1053","370","1423"
"487","2021-06-01","NHS","Orthopaedic","Elbow","1298","4781","6079"
"488","2021-06-01","NHS","Orthopaedic","Foot","4553","2341","6894"
"489","2021-06-01","NHS","Orthopaedic","Hand","6615","4764","11379"
"490","2021-06-01","NHS","Orthopaedic","Hip","6277","1586","7863"
"491","2021-06-01","NHS","Orthopaedic","Knee","8742","4184","12926"
"492","2021-06-01","NHS","Orthopaedic","Shoulder","2967","3887","6854"
"493","2021-07-01","Independent Sector","Orthopaedic","Elbow","211","142","353"
"494","2021-07-01","Independent Sector","Orthopaedic","Foot","1238","222","1460"
"495","2021-07-01","Independent Sector","Orthopaedic","Hand","1918","347","2265"
"496","2021-07-01","Independent Sector","Orthopaedic","Hip","2701","141","2842"
"497","2021-07-01","Independent Sector","Orthopaedic","Knee","4057","593","4650"
"498","2021-07-01","Independent Sector","Orthopaedic","Shoulder","1099","381","1480"
"499","2021-07-01","NHS","Orthopaedic","Elbow","1136","4793","5929"
"500","2021-07-01","NHS","Orthopaedic","Foot","4152","2190","6342"
"501","2021-07-01","NHS","Orthopaedic","Hand","6334","4474","10808"
"502","2021-07-01","NHS","Orthopaedic","Hip","6424","1529","7953"
"503","2021-07-01","NHS","Orthopaedic","Knee","8634","3826","12460"
"504","2021-07-01","NHS","Orthopaedic","Shoulder","2737","3753","6490"
"505","2021-08-01","Independent Sector","Orthopaedic","Elbow","174","140","314"
"506","2021-08-01","Independent Sector","Orthopaedic","Foot","1101","214","1315"
"507","2021-08-01","Independent Sector","Orthopaedic","Hand","1757","348","2105"
"508","2021-08-01","Independent Sector","Orthopaedic","Hip","2466","130","2596"
"509","2021-08-01","Independent Sector","Orthopaedic","Knee","3814","528","4342"
"510","2021-08-01","Independent Sector","Orthopaedic","Shoulder","883","344","1227"
"511","2021-08-01","NHS","Orthopaedic","Elbow","993","4075","5068"
"512","2021-08-01","NHS","Orthopaedic","Foot","3472","1893","5365"
"513","2021-08-01","NHS","Orthopaedic","Hand","5190","3636","8826"
"514","2021-08-01","NHS","Orthopaedic","Hip","5334","1372","6706"
"515","2021-08-01","NHS","Orthopaedic","Knee","7174","3659","10833"
"516","2021-08-01","NHS","Orthopaedic","Shoulder","2139","3355","5494"
"517","2021-09-01","Independent Sector","Orthopaedic","Elbow","191","156","347"
"518","2021-09-01","Independent Sector","Orthopaedic","Foot","1299","249","1548"
"519","2021-09-01","Independent Sector","Orthopaedic","Hand","1952","384","2336"
"520","2021-09-01","Independent Sector","Orthopaedic","Hip","2633","143","2776"
"521","2021-09-01","Independent Sector","Orthopaedic","Knee","3876","580","4456"
"522","2021-09-01","Independent Sector","Orthopaedic","Shoulder","1088","363","1451"
"523","2021-09-01","NHS","Orthopaedic","Elbow","1134","4559","5693"
"524","2021-09-01","NHS","Orthopaedic","Foot","3664","2207","5871"
"525","2021-09-01","NHS","Orthopaedic","Hand","5676","4396","10072"
"526","2021-09-01","NHS","Orthopaedic","Hip","5370","1562","6932"
"527","2021-09-01","NHS","Orthopaedic","Knee","7854","4119","11973"
"528","2021-09-01","NHS","Orthopaedic","Shoulder","2486","3680","6166"
"529","2021-10-01","Independent Sector","Orthopaedic","Elbow","214","133","347"
"530","2021-10-01","Independent Sector","Orthopaedic","Foot","1236","187","1423"
"531","2021-10-01","Independent Sector","Orthopaedic","Hand","1863","335","2198"
"532","2021-10-01","Independent Sector","Orthopaedic","Hip","2626","177","2803"
"533","2021-10-01","Independent Sector","Orthopaedic","Knee","4074","542","4616"
"534","2021-10-01","Independent Sector","Orthopaedic","Shoulder","1032","368","1400"
"535","2021-10-01","NHS","Orthopaedic","Elbow","1053","3776","4829"
"536","2021-10-01","NHS","Orthopaedic","Foot","3776","2039","5815"
"537","2021-10-01","NHS","Orthopaedic","Hand","5804","4048","9852"
"538","2021-10-01","NHS","Orthopaedic","Hip","5466","1470","6936"
"539","2021-10-01","NHS","Orthopaedic","Knee","7954","3442","11396"
"540","2021-10-01","NHS","Orthopaedic","Shoulder","2338","3405","5743"
"541","2021-11-01","Independent Sector","Orthopaedic","Elbow","228","133","361"
"542","2021-11-01","Independent Sector","Orthopaedic","Foot","1272","234","1506"
"543","2021-11-01","Independent Sector","Orthopaedic","Hand","2025","354","2379"
"544","2021-11-01","Independent Sector","Orthopaedic","Hip","2641","218","2859"
"545","2021-11-01","Independent Sector","Orthopaedic","Knee","4103","599","4702"
"546","2021-11-01","Independent Sector","Orthopaedic","Shoulder","1052","342","1394"
"547","2021-11-01","NHS","Orthopaedic","Elbow","1245","3751","4996"
"548","2021-11-01","NHS","Orthopaedic","Foot","4389","2133","6522"
"549","2021-11-01","NHS","Orthopaedic","Hand","6845","4170","11015"
"550","2021-11-01","NHS","Orthopaedic","Hip","5527","1390","6917"
"551","2021-11-01","NHS","Orthopaedic","Knee","8361","3668","12029"
"552","2021-11-01","NHS","Orthopaedic","Shoulder","2815","3164","5979"
"553","2021-12-01","Independent Sector","Orthopaedic","Elbow","177","152","329"
"554","2021-12-01","Independent Sector","Orthopaedic","Foot","953","212","1165"
"555","2021-12-01","Independent Sector","Orthopaedic","Hand","1543","314","1857"
"556","2021-12-01","Independent Sector","Orthopaedic","Hip","2129","165","2294"
"557","2021-12-01","Independent Sector","Orthopaedic","Knee","3475","559","4034"
"558","2021-12-01","Independent Sector","Orthopaedic","Shoulder","802","360","1162"
"559","2021-12-01","NHS","Orthopaedic","Elbow","992","3518","4510"
"560","2021-12-01","NHS","Orthopaedic","Foot","3280","1815","5095"
"561","2021-12-01","NHS","Orthopaedic","Hand","5183","3442","8625"
"562","2021-12-01","NHS","Orthopaedic","Hip","4762","1213","5975"
"563","2021-12-01","NHS","Orthopaedic","Knee","6822","3289","10111"
"564","2021-12-01","NHS","Orthopaedic","Shoulder","2157","2617","4774"
"565","2022-01-01","Independent Sector","Orthopaedic","Elbow","198","140","338"
"566","2022-01-01","Independent Sector","Orthopaedic","Foot","1132","201","1333"
"567","2022-01-01","Independent Sector","Orthopaedic","Hand","1876","317","2193"
"568","2022-01-01","Independent Sector","Orthopaedic","Hip","2175","194","2369"
"569","2022-01-01","Independent Sector","Orthopaedic","Knee","3534","625","4159"
"570","2022-01-01","Independent Sector","Orthopaedic","Shoulder","901","366","1267"
"571","2022-01-01","NHS","Orthopaedic","Elbow","888","3276","4164"
"572","2022-01-01","NHS","Orthopaedic","Foot","3088","1725","4813"
"573","2022-01-01","NHS","Orthopaedic","Hand","5145","3277","8422"
"574","2022-01-01","NHS","Orthopaedic","Hip","3571","1350","4921"
"575","2022-01-01","NHS","Orthopaedic","Knee","5481","3284","8765"
"576","2022-01-01","NHS","Orthopaedic","Shoulder","1849","2702","4551"
"577","2022-02-01","Independent Sector","Orthopaedic","Elbow","219","145","364"
"578","2022-02-01","Independent Sector","Orthopaedic","Foot","1267","192","1459"
"579","2022-02-01","Independent Sector","Orthopaedic","Hand","1925","289","2214"
"580","2022-02-01","Independent Sector","Orthopaedic","Hip","2633","198","2831"
"581","2022-02-01","Independent Sector","Orthopaedic","Knee","4027","577","4604"
"582","2022-02-01","Independent Sector","Orthopaedic","Shoulder","976","350","1326"
"583","2022-02-01","NHS","Orthopaedic","Elbow","1022","3236","4258"
"584","2022-02-01","NHS","Orthopaedic","Foot","3659","1607","5266"
"585","2022-02-01","NHS","Orthopaedic","Hand","5738","3342","9080"
"586","2022-02-01","NHS","Orthopaedic","Hip","4715","1261","5976"
"587","2022-02-01","NHS","Orthopaedic","Knee","6997","3137","10134"
"588","2022-02-01","NHS","Orthopaedic","Shoulder","2249","2561","4810"
"589","2022-03-01","Independent Sector","Orthopaedic","Elbow","287","175","462"
"590","2022-03-01","Independent Sector","Orthopaedic","Foot","1410","223","1633"
"591","2022-03-01","Independent Sector","Orthopaedic","Hand","2289","403","2692"
"592","2022-03-01","Independent Sector","Orthopaedic","Hip","2922","210","3132"
"593","2022-03-01","Independent Sector","Orthopaedic","Knee","4595","735","5330"
"594","2022-03-01","Independent Sector","Orthopaedic","Shoulder","1194","520","1714"
"595","2022-03-01","NHS","Orthopaedic","Elbow","1145","3404","4549"
"596","2022-03-01","NHS","Orthopaedic","Foot","3697","2018","5715"
"597","2022-03-01","NHS","Orthopaedic","Hand","6502","3581","10083"
"598","2022-03-01","NHS","Orthopaedic","Hip","5678","1299","6977"
"599","2022-03-01","NHS","Orthopaedic","Knee","8223","3354","11577"
"600","2022-03-01","NHS","Orthopaedic","Shoulder","2634","2843","5477"
"601","2022-04-01","Independent Sector","Orthopaedic","Elbow","206","145","351"
"602","2022-04-01","Independent Sector","Orthopaedic","Foot","1304","191","1495"
"603","2022-04-01","Independent Sector","Orthopaedic","Hand","2006","316","2322"
"604","2022-04-01","Independent Sector","Orthopaedic","Hip","2473","163","2636"
"605","2022-04-01","Independent Sector","Orthopaedic","Knee","3853","633","4486"
"606","2022-04-01","Independent Sector","Orthopaedic","Shoulder","890","366","1256"
"607","2022-04-01","NHS","Orthopaedic","Elbow","1048","3401","4449"
"608","2022-04-01","NHS","Orthopaedic","Foot","3637","1913","5550"
"609","2022-04-01","NHS","Orthopaedic","Hand","5212","3357","8569"
"610","2022-04-01","NHS","Orthopaedic","Hip","4804","1129","5933"
"611","2022-04-01","NHS","Orthopaedic","Knee","6736","3174","9910"
"612","2022-04-01","NHS","Orthopaedic","Shoulder","2196","2662","4858"
"613","2022-05-01","Independent Sector","Orthopaedic","Elbow","233","138","371"
"614","2022-05-01","Independent Sector","Orthopaedic","Foot","1382","237","1619"
"615","2022-05-01","Independent Sector","Orthopaedic","Hand","2102","397","2499"
"616","2022-05-01","Independent Sector","Orthopaedic","Hip","2776","208","2984"
"617","2022-05-01","Independent Sector","Orthopaedic","Knee","4388","724","5112"
"618","2022-05-01","Independent Sector","Orthopaedic","Shoulder","1058","479","1537"
"619","2022-05-01","NHS","Orthopaedic","Elbow","1189","3895","5084"
"620","2022-05-01","NHS","Orthopaedic","Foot","4442","2328","6770"
"621","2022-05-01","NHS","Orthopaedic","Hand","6767","4110","10877"
"622","2022-05-01","NHS","Orthopaedic","Hip","5765","1261","7026"
"623","2022-05-01","NHS","Orthopaedic","Knee","8015","3664","11679"
"624","2022-05-01","NHS","Orthopaedic","Shoulder","2567","3115","5682"
"625","2022-06-01","Independent Sector","Orthopaedic","Elbow","197","165","362"
"626","2022-06-01","Independent Sector","Orthopaedic","Foot","1328","230","1558"
"627","2022-06-01","Independent Sector","Orthopaedic","Hand","2098","301","2399"
"628","2022-06-01","Independent Sector","Orthopaedic","Hip","2762","194","2956"
"629","2022-06-01","Independent Sector","Orthopaedic","Knee","4116","745","4861"
"630","2022-06-01","Independent Sector","Orthopaedic","Shoulder","1020","425","1445"
"631","2022-06-01","NHS","Orthopaedic","Elbow","964","3904","4868"
"632","2022-06-01","NHS","Orthopaedic","Foot","4064","2208","6272"
"633","2022-06-01","NHS","Orthopaedic","Hand","5620","3938","9558"
"634","2022-06-01","NHS","Orthopaedic","Hip","5456","1222","6678"
"635","2022-06-01","NHS","Orthopaedic","Knee","7797","3490","11287"
"636","2022-06-01","NHS","Orthopaedic","Shoulder","2264","3022","5286"
"637","2022-07-01","Independent Sector","Orthopaedic","Elbow","211","137","348"
"638","2022-07-01","Independent Sector","Orthopaedic","Foot","1253","221","1474"
"639","2022-07-01","Independent Sector","Orthopaedic","Hand","2125","370","2495"
"640","2022-07-01","Independent Sector","Orthopaedic","Hip","2801","189","2990"
"641","2022-07-01","Independent Sector","Orthopaedic","Knee","4356","620","4976"
"642","2022-07-01","Independent Sector","Orthopaedic","Shoulder","971","364","1335"
"643","2022-07-01","NHS","Orthopaedic","Elbow","1060","3881","4941"
"644","2022-07-01","NHS","Orthopaedic","Foot","3764","1944","5708"
"645","2022-07-01","NHS","Orthopaedic","Hand","6061","3470","9531"
"646","2022-07-01","NHS","Orthopaedic","Hip","5323","1145","6468"
"647","2022-07-01","NHS","Orthopaedic","Knee","7375","3214","10589"
"648","2022-07-01","NHS","Orthopaedic","Shoulder","2265","2850","5115"
"649","2022-08-01","Independent Sector","Orthopaedic","Elbow","216","149","365"
"650","2022-08-01","Independent Sector","Orthopaedic","Foot","1368","200","1568"
"651","2022-08-01","Independent Sector","Orthopaedic","Hand","2218","382","2600"
"652","2022-08-01","Independent Sector","Orthopaedic","Hip","2849","203","3052"
"653","2022-08-01","Independent Sector","Orthopaedic","Knee","4214","637","4851"
"654","2022-08-01","Independent Sector","Orthopaedic","Shoulder","988","424","1412"
"655","2022-08-01","NHS","Orthopaedic","Elbow","1042","3966","5008"
"656","2022-08-01","NHS","Orthopaedic","Foot","3873","1856","5729"
"657","2022-08-01","NHS","Orthopaedic","Hand","6171","3598","9769"
"658","2022-08-01","NHS","Orthopaedic","Hip","5392","1167","6559"
"659","2022-08-01","NHS","Orthopaedic","Knee","7659","3414","11073"
"660","2022-08-01","NHS","Orthopaedic","Shoulder","2271","3090","5361"
"661","2022-09-01","Independent Sector","Orthopaedic","Elbow","224","129","353"
"662","2022-09-01","Independent Sector","Orthopaedic","Foot","1477","224","1701"
"663","2022-09-01","Independent Sector","Orthopaedic","Hand","2380","395","2775"
"664","2022-09-01","Independent Sector","Orthopaedic","Hip","2889","219","3108"
"665","2022-09-01","Independent Sector","Orthopaedic","Knee","4570","716","5286"
"666","2022-09-01","Independent Sector","Orthopaedic","Shoulder","1075","407","1482"
"667","2022-09-01","NHS","Orthopaedic","Elbow","1160","3906","5066"
"668","2022-09-01","NHS","Orthopaedic","Foot","4255","1837","6092"
"669","2022-09-01","NHS","Orthopaedic","Hand","6376","3460","9836"
"670","2022-09-01","NHS","Orthopaedic","Hip","5544","1121","6665"
"671","2022-09-01","NHS","Orthopaedic","Knee","7897","3418","11315"
"672","2022-09-01","NHS","Orthopaedic","Shoulder","2442","3279","5721"
"673","2022-10-01","Independent Sector","Orthopaedic","Elbow","221","117","338"
"674","2022-10-01","Independent Sector","Orthopaedic","Foot","1466","238","1704"
"675","2022-10-01","Independent Sector","Orthopaedic","Hand","2343","459","2802"
"676","2022-10-01","Independent Sector","Orthopaedic","Hip","2993","183","3176"
"677","2022-10-01","Independent Sector","Orthopaedic","Knee","4780","672","5452"
"678","2022-10-01","Independent Sector","Orthopaedic","Shoulder","974","439","1413"
"679","2022-10-01","NHS","Orthopaedic","Elbow","1084","3558","4642"
"680","2022-10-01","NHS","Orthopaedic","Foot","4334","1720","6054"
"681","2022-10-01","NHS","Orthopaedic","Hand","6210","3414","9624"
"682","2022-10-01","NHS","Orthopaedic","Hip","5475","1063","6538"
"683","2022-10-01","NHS","Orthopaedic","Knee","8045","3415","11460"
"684","2022-10-01","NHS","Orthopaedic","Shoulder","2612","2655","5267"