"","der_activity_month","type","speciality","procedure_desc_short","n_spells_IP","n_spells_OP","all_activity"
"1","2018-02-01","Independent Sector","Ophthalmology","Cataract","7153","296","7449"
"2","2018-02-01","Independent Sector","Ophthalmology","Cornea and Sclera","9","2","11"
"3","2018-02-01","Independent Sector","Ophthalmology","Glaucoma","8","31","39"
"4","2018-02-01","Independent Sector","Ophthalmology","Ocular Motility","7","0","7"
"5","2018-02-01","Independent Sector","Ophthalmology","Oculoplastics","187","39","226"
"6","2018-02-01","Independent Sector","Ophthalmology","Orbit and Lacrimal","33","15","48"
"7","2018-02-01","Independent Sector","Ophthalmology","Vitreous Retinal","1392","2659","4051"
"8","2018-02-01","NHS","Ophthalmology","Cataract","26664","4074","30738"
"9","2018-02-01","NHS","Ophthalmology","Cornea and Sclera","1015","2722","3737"
"10","2018-02-01","NHS","Ophthalmology","Glaucoma","2100","2507","4607"
"11","2018-02-01","NHS","Ophthalmology","Ocular Motility","915","84","999"
"12","2018-02-01","NHS","Ophthalmology","Oculoplastics","4852","2399","7251"
"13","2018-02-01","NHS","Ophthalmology","Orbit and Lacrimal","965","1198","2163"
"14","2018-02-01","NHS","Ophthalmology","Vitreous Retinal","8389","189951","198340"
"15","2018-03-01","Independent Sector","Ophthalmology","Cataract","7044","300","7344"
"16","2018-03-01","Independent Sector","Ophthalmology","Cornea and Sclera","6","1","7"
"17","2018-03-01","Independent Sector","Ophthalmology","Glaucoma","9","37","46"
"18","2018-03-01","Independent Sector","Ophthalmology","Ocular Motility","9","0","9"
"19","2018-03-01","Independent Sector","Ophthalmology","Oculoplastics","157","21","178"
"20","2018-03-01","Independent Sector","Ophthalmology","Orbit and Lacrimal","38","12","50"
"21","2018-03-01","Independent Sector","Ophthalmology","Vitreous Retinal","1428","3223","4651"
"22","2018-03-01","NHS","Ophthalmology","Cataract","26733","4418","31151"
"23","2018-03-01","NHS","Ophthalmology","Cornea and Sclera","1135","2648","3783"
"24","2018-03-01","NHS","Ophthalmology","Glaucoma","2160","2688","4848"
"25","2018-03-01","NHS","Ophthalmology","Ocular Motility","963","138","1101"
"26","2018-03-01","NHS","Ophthalmology","Oculoplastics","5102","2552","7654"
"27","2018-03-01","NHS","Ophthalmology","Orbit and Lacrimal","983","1204","2187"
"28","2018-03-01","NHS","Ophthalmology","Vitreous Retinal","8649","193880","202529"
"29","2018-04-01","Independent Sector","Ophthalmology","Cataract","7332","355","7687"
"30","2018-04-01","Independent Sector","Ophthalmology","Cornea and Sclera","6","1","7"
"31","2018-04-01","Independent Sector","Ophthalmology","Glaucoma","8","46","54"
"32","2018-04-01","Independent Sector","Ophthalmology","Ocular Motility","1","0","1"
"33","2018-04-01","Independent Sector","Ophthalmology","Oculoplastics","198","32","230"
"34","2018-04-01","Independent Sector","Ophthalmology","Orbit and Lacrimal","49","14","63"
"35","2018-04-01","Independent Sector","Ophthalmology","Vitreous Retinal","880","3732","4612"
"36","2018-04-01","NHS","Ophthalmology","Cataract","26388","4202","30590"
"37","2018-04-01","NHS","Ophthalmology","Cornea and Sclera","1161","1491","2652"
"38","2018-04-01","NHS","Ophthalmology","Glaucoma","1986","2559","4545"
"39","2018-04-01","NHS","Ophthalmology","Ocular Motility","961","115","1076"
"40","2018-04-01","NHS","Ophthalmology","Oculoplastics","4920","2556","7476"
"41","2018-04-01","NHS","Ophthalmology","Orbit and Lacrimal","1047","1327","2374"
"42","2018-04-01","NHS","Ophthalmology","Vitreous Retinal","8861","197259","206120"
"43","2018-05-01","Independent Sector","Ophthalmology","Cataract","8076","397","8473"
"44","2018-05-01","Independent Sector","Ophthalmology","Cornea and Sclera","9","1","10"
"45","2018-05-01","Independent Sector","Ophthalmology","Glaucoma","13","43","56"
"46","2018-05-01","Independent Sector","Ophthalmology","Ocular Motility","10","0","10"
"47","2018-05-01","Independent Sector","Ophthalmology","Oculoplastics","155","39","194"
"48","2018-05-01","Independent Sector","Ophthalmology","Orbit and Lacrimal","25","18","43"
"49","2018-05-01","Independent Sector","Ophthalmology","Vitreous Retinal","915","3936","4851"
"50","2018-05-01","NHS","Ophthalmology","Cataract","28515","4691","33206"
"51","2018-05-01","NHS","Ophthalmology","Cornea and Sclera","1165","2911","4076"
"52","2018-05-01","NHS","Ophthalmology","Glaucoma","2106","2840","4946"
"53","2018-05-01","NHS","Ophthalmology","Ocular Motility","1016","140","1156"
"54","2018-05-01","NHS","Ophthalmology","Oculoplastics","5481","2698","8179"
"55","2018-05-01","NHS","Ophthalmology","Orbit and Lacrimal","1147","1342","2489"
"56","2018-05-01","NHS","Ophthalmology","Vitreous Retinal","9093","211367","220460"
"57","2018-06-01","Independent Sector","Ophthalmology","Cataract","8345","395","8740"
"58","2018-06-01","Independent Sector","Ophthalmology","Cornea and Sclera","4","4","8"
"59","2018-06-01","Independent Sector","Ophthalmology","Glaucoma","18","26","44"
"60","2018-06-01","Independent Sector","Ophthalmology","Ocular Motility","8","0","8"
"61","2018-06-01","Independent Sector","Ophthalmology","Oculoplastics","216","39","255"
"62","2018-06-01","Independent Sector","Ophthalmology","Orbit and Lacrimal","38","21","59"
"63","2018-06-01","Independent Sector","Ophthalmology","Vitreous Retinal","844","4250","5094"
"64","2018-06-01","NHS","Ophthalmology","Cataract","28874","4522","33396"
"65","2018-06-01","NHS","Ophthalmology","Cornea and Sclera","1205","2544","3749"
"66","2018-06-01","NHS","Ophthalmology","Glaucoma","2197","2714","4911"
"67","2018-06-01","NHS","Ophthalmology","Ocular Motility","1000","142","1142"
"68","2018-06-01","NHS","Ophthalmology","Oculoplastics","4990","2832","7822"
"69","2018-06-01","NHS","Ophthalmology","Orbit and Lacrimal","1129","1267","2396"
"70","2018-06-01","NHS","Ophthalmology","Vitreous Retinal","9260","212164","221424"
"71","2018-07-01","Independent Sector","Ophthalmology","Cataract","8069","382","8451"
"72","2018-07-01","Independent Sector","Ophthalmology","Cornea and Sclera","9","21","30"
"73","2018-07-01","Independent Sector","Ophthalmology","Glaucoma","15","41","56"
"74","2018-07-01","Independent Sector","Ophthalmology","Ocular Motility","12","0","12"
"75","2018-07-01","Independent Sector","Ophthalmology","Oculoplastics","148","50","198"
"76","2018-07-01","Independent Sector","Ophthalmology","Orbit and Lacrimal","28","14","42"
"77","2018-07-01","Independent Sector","Ophthalmology","Vitreous Retinal","796","4189","4985"
"78","2018-07-01","NHS","Ophthalmology","Cataract","28695","4924","33619"
"79","2018-07-01","NHS","Ophthalmology","Cornea and Sclera","1297","2005","3302"
"80","2018-07-01","NHS","Ophthalmology","Glaucoma","2070","2868","4938"
"81","2018-07-01","NHS","Ophthalmology","Ocular Motility","975","106","1081"
"82","2018-07-01","NHS","Ophthalmology","Oculoplastics","5272","2900","8172"
"83","2018-07-01","NHS","Ophthalmology","Orbit and Lacrimal","1142","1165","2307"
"84","2018-07-01","NHS","Ophthalmology","Vitreous Retinal","9409","213849","223258"
"85","2018-08-01","Independent Sector","Ophthalmology","Cataract","8440","405","8845"
"86","2018-08-01","Independent Sector","Ophthalmology","Cornea and Sclera","7","7","14"
"87","2018-08-01","Independent Sector","Ophthalmology","Glaucoma","19","59","78"
"88","2018-08-01","Independent Sector","Ophthalmology","Ocular Motility","7","0","7"
"89","2018-08-01","Independent Sector","Ophthalmology","Oculoplastics","182","39","221"
"90","2018-08-01","Independent Sector","Ophthalmology","Orbit and Lacrimal","29","14","43"
"91","2018-08-01","Independent Sector","Ophthalmology","Vitreous Retinal","853","4142","4995"
"92","2018-08-01","NHS","Ophthalmology","Cataract","26527","4127","30654"
"93","2018-08-01","NHS","Ophthalmology","Cornea and Sclera","1127","2221","3348"
"94","2018-08-01","NHS","Ophthalmology","Glaucoma","1929","2479","4408"
"95","2018-08-01","NHS","Ophthalmology","Ocular Motility","997","131","1128"
"96","2018-08-01","NHS","Ophthalmology","Oculoplastics","4937","2587","7524"
"97","2018-08-01","NHS","Ophthalmology","Orbit and Lacrimal","1053","1197","2250"
"98","2018-08-01","NHS","Ophthalmology","Vitreous Retinal","9148","210564","219712"
"99","2018-09-01","Independent Sector","Ophthalmology","Cataract","8526","436","8962"
"100","2018-09-01","Independent Sector","Ophthalmology","Cornea and Sclera","11","27","38"
"101","2018-09-01","Independent Sector","Ophthalmology","Glaucoma","17","54","71"
"102","2018-09-01","Independent Sector","Ophthalmology","Ocular Motility","3","0","3"
"103","2018-09-01","Independent Sector","Ophthalmology","Oculoplastics","166","30","196"
"104","2018-09-01","Independent Sector","Ophthalmology","Orbit and Lacrimal","34","21","55"
"105","2018-09-01","Independent Sector","Ophthalmology","Vitreous Retinal","807","4240","5047"
"106","2018-09-01","NHS","Ophthalmology","Cataract","26642","4196","30838"
"107","2018-09-01","NHS","Ophthalmology","Cornea and Sclera","1064","2429","3493"
"108","2018-09-01","NHS","Ophthalmology","Glaucoma","1885","2388","4273"
"109","2018-09-01","NHS","Ophthalmology","Ocular Motility","944","129","1073"
"110","2018-09-01","NHS","Ophthalmology","Oculoplastics","4749","2520","7269"
"111","2018-09-01","NHS","Ophthalmology","Orbit and Lacrimal","993","1216","2209"
"112","2018-09-01","NHS","Ophthalmology","Vitreous Retinal","8337","205040","213377"
"113","2018-10-01","Independent Sector","Ophthalmology","Cataract","9680","490","10170"
"114","2018-10-01","Independent Sector","Ophthalmology","Cornea and Sclera","8","9","17"
"115","2018-10-01","Independent Sector","Ophthalmology","Glaucoma","13","47","60"
"116","2018-10-01","Independent Sector","Ophthalmology","Ocular Motility","6","0","6"
"117","2018-10-01","Independent Sector","Ophthalmology","Oculoplastics","187","37","224"
"118","2018-10-01","Independent Sector","Ophthalmology","Orbit and Lacrimal","31","14","45"
"119","2018-10-01","Independent Sector","Ophthalmology","Vitreous Retinal","925","4530","5455"
"120","2018-10-01","NHS","Ophthalmology","Cataract","30693","5326","36019"
"121","2018-10-01","NHS","Ophthalmology","Cornea and Sclera","1256","2776","4032"
"122","2018-10-01","NHS","Ophthalmology","Glaucoma","2213","3332","5545"
"123","2018-10-01","NHS","Ophthalmology","Ocular Motility","1042","177","1219"
"124","2018-10-01","NHS","Ophthalmology","Oculoplastics","5706","2768","8474"
"125","2018-10-01","NHS","Ophthalmology","Orbit and Lacrimal","1141","1437","2578"
"126","2018-10-01","NHS","Ophthalmology","Vitreous Retinal","9957","234266","244223"
"127","2018-11-01","Independent Sector","Ophthalmology","Cataract","10070","484","10554"
"128","2018-11-01","Independent Sector","Ophthalmology","Cornea and Sclera","14","1","15"
"129","2018-11-01","Independent Sector","Ophthalmology","Glaucoma","21","28","49"
"130","2018-11-01","Independent Sector","Ophthalmology","Ocular Motility","4","0","4"
"131","2018-11-01","Independent Sector","Ophthalmology","Oculoplastics","190","35","225"
"132","2018-11-01","Independent Sector","Ophthalmology","Orbit and Lacrimal","39","19","58"
"133","2018-11-01","Independent Sector","Ophthalmology","Vitreous Retinal","974","4596","5570"
"134","2018-11-01","NHS","Ophthalmology","Cataract","29966","5087","35053"
"135","2018-11-01","NHS","Ophthalmology","Cornea and Sclera","1302","2926","4228"
"136","2018-11-01","NHS","Ophthalmology","Glaucoma","2262","3185","5447"
"137","2018-11-01","NHS","Ophthalmology","Ocular Motility","1050","151","1201"
"138","2018-11-01","NHS","Ophthalmology","Oculoplastics","5405","2756","8161"
"139","2018-11-01","NHS","Ophthalmology","Orbit and Lacrimal","1172","1348","2520"
"140","2018-11-01","NHS","Ophthalmology","Vitreous Retinal","9747","224035","233782"
"141","2018-12-01","Independent Sector","Ophthalmology","Cataract","7938","417","8355"
"142","2018-12-01","Independent Sector","Ophthalmology","Cornea and Sclera","12","1","13"
"143","2018-12-01","Independent Sector","Ophthalmology","Glaucoma","13","52","65"
"144","2018-12-01","Independent Sector","Ophthalmology","Ocular Motility","8","0","8"
"145","2018-12-01","Independent Sector","Ophthalmology","Oculoplastics","130","41","171"
"146","2018-12-01","Independent Sector","Ophthalmology","Orbit and Lacrimal","23","7","30"
"147","2018-12-01","Independent Sector","Ophthalmology","Vitreous Retinal","734","3799","4533"
"148","2018-12-01","NHS","Ophthalmology","Cataract","23418","3977","27395"
"149","2018-12-01","NHS","Ophthalmology","Cornea and Sclera","962","2085","3047"
"150","2018-12-01","NHS","Ophthalmology","Glaucoma","1533","2440","3973"
"151","2018-12-01","NHS","Ophthalmology","Ocular Motility","822","141","963"
"152","2018-12-01","NHS","Ophthalmology","Oculoplastics","4352","2488","6840"
"153","2018-12-01","NHS","Ophthalmology","Orbit and Lacrimal","883","1086","1969"
"154","2018-12-01","NHS","Ophthalmology","Vitreous Retinal","8300","182523","190823"
"155","2019-01-01","Independent Sector","Ophthalmology","Cataract","10607","426","11033"
"156","2019-01-01","Independent Sector","Ophthalmology","Cornea and Sclera","11","2","13"
"157","2019-01-01","Independent Sector","Ophthalmology","Glaucoma","20","45","65"
"158","2019-01-01","Independent Sector","Ophthalmology","Ocular Motility","9","0","9"
"159","2019-01-01","Independent Sector","Ophthalmology","Oculoplastics","200","52","252"
"160","2019-01-01","Independent Sector","Ophthalmology","Orbit and Lacrimal","37","22","59"
"161","2019-01-01","Independent Sector","Ophthalmology","Vitreous Retinal","958","4747","5705"
"162","2019-01-01","NHS","Ophthalmology","Cataract","29985","5179","35164"
"163","2019-01-01","NHS","Ophthalmology","Cornea and Sclera","1200","2399","3599"
"164","2019-01-01","NHS","Ophthalmology","Glaucoma","2321","3181","5502"
"165","2019-01-01","NHS","Ophthalmology","Ocular Motility","1070","54","1124"
"166","2019-01-01","NHS","Ophthalmology","Oculoplastics","5468","2734","8202"
"167","2019-01-01","NHS","Ophthalmology","Orbit and Lacrimal","1142","1311","2453"
"168","2019-01-01","NHS","Ophthalmology","Vitreous Retinal","9755","234135","243890"
"169","2019-02-01","Independent Sector","Ophthalmology","Cataract","10047","418","10465"
"170","2019-02-01","Independent Sector","Ophthalmology","Cornea and Sclera","10","0","10"
"171","2019-02-01","Independent Sector","Ophthalmology","Glaucoma","24","57","81"
"172","2019-02-01","Independent Sector","Ophthalmology","Ocular Motility","4","0","4"
"173","2019-02-01","Independent Sector","Ophthalmology","Oculoplastics","176","40","216"
"174","2019-02-01","Independent Sector","Ophthalmology","Orbit and Lacrimal","38","29","67"
"175","2019-02-01","Independent Sector","Ophthalmology","Vitreous Retinal","844","4449","5293"
"176","2019-02-01","NHS","Ophthalmology","Cataract","27891","4520","32411"
"177","2019-02-01","NHS","Ophthalmology","Cornea and Sclera","1069","2151","3220"
"178","2019-02-01","NHS","Ophthalmology","Glaucoma","2188","2786","4974"
"179","2019-02-01","NHS","Ophthalmology","Ocular Motility","978","53","1031"
"180","2019-02-01","NHS","Ophthalmology","Oculoplastics","4987","2697","7684"
"181","2019-02-01","NHS","Ophthalmology","Orbit and Lacrimal","982","1266","2248"
"182","2019-02-01","NHS","Ophthalmology","Vitreous Retinal","8759","205557","214316"
"183","2019-03-01","Independent Sector","Ophthalmology","Cataract","11253","484","11737"
"184","2019-03-01","Independent Sector","Ophthalmology","Cornea and Sclera","20","3","23"
"185","2019-03-01","Independent Sector","Ophthalmology","Glaucoma","24","52","76"
"186","2019-03-01","Independent Sector","Ophthalmology","Ocular Motility","9","0","9"
"187","2019-03-01","Independent Sector","Ophthalmology","Oculoplastics","151","53","204"
"188","2019-03-01","Independent Sector","Ophthalmology","Orbit and Lacrimal","35","19","54"
"189","2019-03-01","Independent Sector","Ophthalmology","Vitreous Retinal","982","4953","5935"
"190","2019-03-01","NHS","Ophthalmology","Cataract","29571","4583","34154"
"191","2019-03-01","NHS","Ophthalmology","Cornea and Sclera","1128","2217","3345"
"192","2019-03-01","NHS","Ophthalmology","Glaucoma","2139","2861","5000"
"193","2019-03-01","NHS","Ophthalmology","Ocular Motility","933","84","1017"
"194","2019-03-01","NHS","Ophthalmology","Oculoplastics","5097","2605","7702"
"195","2019-03-01","NHS","Ophthalmology","Orbit and Lacrimal","1080","1327","2407"
"196","2019-03-01","NHS","Ophthalmology","Vitreous Retinal","9498","217246","226744"
"197","2019-04-01","Independent Sector","Ophthalmology","Cataract","8746","449","9195"
"198","2019-04-01","Independent Sector","Ophthalmology","Cornea and Sclera","17","0","17"
"199","2019-04-01","Independent Sector","Ophthalmology","Glaucoma","17","71","88"
"200","2019-04-01","Independent Sector","Ophthalmology","Ocular Motility","4","0","4"
"201","2019-04-01","Independent Sector","Ophthalmology","Oculoplastics","146","34","180"
"202","2019-04-01","Independent Sector","Ophthalmology","Orbit and Lacrimal","20","17","37"
"203","2019-04-01","Independent Sector","Ophthalmology","Vitreous Retinal","1095","4650","5745"
"204","2019-04-01","NHS","Ophthalmology","Cataract","26545","3961","30506"
"205","2019-04-01","NHS","Ophthalmology","Cornea and Sclera","1105","1561","2666"
"206","2019-04-01","NHS","Ophthalmology","Glaucoma","2034","2543","4577"
"207","2019-04-01","NHS","Ophthalmology","Ocular Motility","923","68","991"
"208","2019-04-01","NHS","Ophthalmology","Oculoplastics","4826","2554","7380"
"209","2019-04-01","NHS","Ophthalmology","Orbit and Lacrimal","987","1240","2227"
"210","2019-04-01","NHS","Ophthalmology","Vitreous Retinal","9527","205650","215177"
"211","2019-05-01","Independent Sector","Ophthalmology","Cataract","10707","505","11212"
"212","2019-05-01","Independent Sector","Ophthalmology","Cornea and Sclera","20","3","23"
"213","2019-05-01","Independent Sector","Ophthalmology","Glaucoma","17","41","58"
"214","2019-05-01","Independent Sector","Ophthalmology","Ocular Motility","13","0","13"
"215","2019-05-01","Independent Sector","Ophthalmology","Oculoplastics","146","58","204"
"216","2019-05-01","Independent Sector","Ophthalmology","Orbit and Lacrimal","33","37","70"
"217","2019-05-01","Independent Sector","Ophthalmology","Vitreous Retinal","1259","5339","6598"
"218","2019-05-01","NHS","Ophthalmology","Cataract","28165","4526","32691"
"219","2019-05-01","NHS","Ophthalmology","Cornea and Sclera","1173","2174","3347"
"220","2019-05-01","NHS","Ophthalmology","Glaucoma","2206","3273","5479"
"221","2019-05-01","NHS","Ophthalmology","Ocular Motility","905","66","971"
"222","2019-05-01","NHS","Ophthalmology","Oculoplastics","5209","2734","7943"
"223","2019-05-01","NHS","Ophthalmology","Orbit and Lacrimal","1105","1203","2308"
"224","2019-05-01","NHS","Ophthalmology","Vitreous Retinal","10117","218194","228311"
"225","2019-06-01","Independent Sector","Ophthalmology","Cataract","11162","418","11580"
"226","2019-06-01","Independent Sector","Ophthalmology","Cornea and Sclera","21","1","22"
"227","2019-06-01","Independent Sector","Ophthalmology","Glaucoma","30","47","77"
"228","2019-06-01","Independent Sector","Ophthalmology","Ocular Motility","4","0","4"
"229","2019-06-01","Independent Sector","Ophthalmology","Oculoplastics","160","49","209"
"230","2019-06-01","Independent Sector","Ophthalmology","Orbit and Lacrimal","37","32","69"
"231","2019-06-01","Independent Sector","Ophthalmology","Vitreous Retinal","1234","4894","6128"
"232","2019-06-01","NHS","Ophthalmology","Cataract","27871","4301","32172"
"233","2019-06-01","NHS","Ophthalmology","Cornea and Sclera","1192","2270","3462"
"234","2019-06-01","NHS","Ophthalmology","Glaucoma","2213","3439","5652"
"235","2019-06-01","NHS","Ophthalmology","Ocular Motility","917","87","1004"
"236","2019-06-01","NHS","Ophthalmology","Oculoplastics","4733","2630","7363"
"237","2019-06-01","NHS","Ophthalmology","Orbit and Lacrimal","1035","951","1986"
"238","2019-06-01","NHS","Ophthalmology","Vitreous Retinal","9386","212638","222024"
"239","2019-07-01","Independent Sector","Ophthalmology","Cataract","12315","529","12844"
"240","2019-07-01","Independent Sector","Ophthalmology","Cornea and Sclera","17","1","18"
"241","2019-07-01","Independent Sector","Ophthalmology","Glaucoma","23","58","81"
"242","2019-07-01","Independent Sector","Ophthalmology","Ocular Motility","11","0","11"
"243","2019-07-01","Independent Sector","Ophthalmology","Oculoplastics","185","50","235"
"244","2019-07-01","Independent Sector","Ophthalmology","Orbit and Lacrimal","46","22","68"
"245","2019-07-01","Independent Sector","Ophthalmology","Vitreous Retinal","1353","6131","7484"
"246","2019-07-01","NHS","Ophthalmology","Cataract","30461","4803","35264"
"247","2019-07-01","NHS","Ophthalmology","Cornea and Sclera","1309","2475","3784"
"248","2019-07-01","NHS","Ophthalmology","Glaucoma","2203","3575","5778"
"249","2019-07-01","NHS","Ophthalmology","Ocular Motility","1107","92","1199"
"250","2019-07-01","NHS","Ophthalmology","Oculoplastics","5375","2905","8280"
"251","2019-07-01","NHS","Ophthalmology","Orbit and Lacrimal","1152","1110","2262"
"252","2019-07-01","NHS","Ophthalmology","Vitreous Retinal","10579","233690","244269"
"253","2019-08-01","Independent Sector","Ophthalmology","Cataract","10788","659","11447"
"254","2019-08-01","Independent Sector","Ophthalmology","Cornea and Sclera","22","2","24"
"255","2019-08-01","Independent Sector","Ophthalmology","Glaucoma","9","55","64"
"256","2019-08-01","Independent Sector","Ophthalmology","Ocular Motility","5","0","5"
"257","2019-08-01","Independent Sector","Ophthalmology","Oculoplastics","138","45","183"
"258","2019-08-01","Independent Sector","Ophthalmology","Orbit and Lacrimal","18","22","40"
"259","2019-08-01","Independent Sector","Ophthalmology","Vitreous Retinal","1146","5654","6800"
"260","2019-08-01","NHS","Ophthalmology","Cataract","26416","4031","30447"
"261","2019-08-01","NHS","Ophthalmology","Cornea and Sclera","1100","2460","3560"
"262","2019-08-01","NHS","Ophthalmology","Glaucoma","1880","3074","4954"
"263","2019-08-01","NHS","Ophthalmology","Ocular Motility","892","90","982"
"264","2019-08-01","NHS","Ophthalmology","Oculoplastics","4676","2325","7001"
"265","2019-08-01","NHS","Ophthalmology","Orbit and Lacrimal","943","1021","1964"
"266","2019-08-01","NHS","Ophthalmology","Vitreous Retinal","9380","205687","215067"
"267","2019-09-01","Independent Sector","Ophthalmology","Cataract","12317","647","12964"
"268","2019-09-01","Independent Sector","Ophthalmology","Cornea and Sclera","36","2","38"
"269","2019-09-01","Independent Sector","Ophthalmology","Glaucoma","24","46","70"
"270","2019-09-01","Independent Sector","Ophthalmology","Ocular Motility","7","0","7"
"271","2019-09-01","Independent Sector","Ophthalmology","Oculoplastics","223","50","273"
"272","2019-09-01","Independent Sector","Ophthalmology","Orbit and Lacrimal","49","18","67"
"273","2019-09-01","Independent Sector","Ophthalmology","Vitreous Retinal","1308","6454","7762"
"274","2019-09-01","NHS","Ophthalmology","Cataract","28223","4355","32578"
"275","2019-09-01","NHS","Ophthalmology","Cornea and Sclera","1231","2453","3684"
"276","2019-09-01","NHS","Ophthalmology","Glaucoma","2105","3287","5392"
"277","2019-09-01","NHS","Ophthalmology","Ocular Motility","981","116","1097"
"278","2019-09-01","NHS","Ophthalmology","Oculoplastics","4806","2641","7447"
"279","2019-09-01","NHS","Ophthalmology","Orbit and Lacrimal","1051","1203","2254"
"280","2019-09-01","NHS","Ophthalmology","Vitreous Retinal","9734","220521","230255"
"281","2019-10-01","Independent Sector","Ophthalmology","Cataract","12888","510","13398"
"282","2019-10-01","Independent Sector","Ophthalmology","Cornea and Sclera","32","2","34"
"283","2019-10-01","Independent Sector","Ophthalmology","Glaucoma","15","64","79"
"284","2019-10-01","Independent Sector","Ophthalmology","Ocular Motility","4","0","4"
"285","2019-10-01","Independent Sector","Ophthalmology","Oculoplastics","196","46","242"
"286","2019-10-01","Independent Sector","Ophthalmology","Orbit and Lacrimal","27","12","39"
"287","2019-10-01","Independent Sector","Ophthalmology","Vitreous Retinal","1433","6260","7693"
"288","2019-10-01","NHS","Ophthalmology","Cataract","31013","4641","35654"
"289","2019-10-01","NHS","Ophthalmology","Cornea and Sclera","1277","3012","4289"
"290","2019-10-01","NHS","Ophthalmology","Glaucoma","2332","3780","6112"
"291","2019-10-01","NHS","Ophthalmology","Ocular Motility","1025","92","1117"
"292","2019-10-01","NHS","Ophthalmology","Oculoplastics","5611","2749","8360"
"293","2019-10-01","NHS","Ophthalmology","Orbit and Lacrimal","1085","1281","2366"
"294","2019-10-01","NHS","Ophthalmology","Vitreous Retinal","10547","244005","254552"
"295","2019-11-01","Independent Sector","Ophthalmology","Cataract","13000","638","13638"
"296","2019-11-01","Independent Sector","Ophthalmology","Cornea and Sclera","41","3","44"
"297","2019-11-01","Independent Sector","Ophthalmology","Glaucoma","18","72","90"
"298","2019-11-01","Independent Sector","Ophthalmology","Ocular Motility","9","0","9"
"299","2019-11-01","Independent Sector","Ophthalmology","Oculoplastics","230","54","284"
"300","2019-11-01","Independent Sector","Ophthalmology","Orbit and Lacrimal","53","7","60"
"301","2019-11-01","Independent Sector","Ophthalmology","Vitreous Retinal","1434","7197","8631"
"302","2019-11-01","NHS","Ophthalmology","Cataract","30434","4178","34612"
"303","2019-11-01","NHS","Ophthalmology","Cornea and Sclera","1302","2801","4103"
"304","2019-11-01","NHS","Ophthalmology","Glaucoma","2078","3523","5601"
"305","2019-11-01","NHS","Ophthalmology","Ocular Motility","1008","70","1078"
"306","2019-11-01","NHS","Ophthalmology","Oculoplastics","5313","2545","7858"
"307","2019-11-01","NHS","Ophthalmology","Orbit and Lacrimal","1127","1100","2227"
"308","2019-11-01","NHS","Ophthalmology","Vitreous Retinal","10001","228195","238196"
"309","2019-12-01","Independent Sector","Ophthalmology","Cataract","9955","456","10411"
"310","2019-12-01","Independent Sector","Ophthalmology","Cornea and Sclera","34","1","35"
"311","2019-12-01","Independent Sector","Ophthalmology","Glaucoma","23","57","80"
"312","2019-12-01","Independent Sector","Ophthalmology","Ocular Motility","9","0","9"
"313","2019-12-01","Independent Sector","Ophthalmology","Oculoplastics","140","37","177"
"314","2019-12-01","Independent Sector","Ophthalmology","Orbit and Lacrimal","28","14","42"
"315","2019-12-01","Independent Sector","Ophthalmology","Vitreous Retinal","1289","5828","7117"
"316","2019-12-01","NHS","Ophthalmology","Cataract","25018","3605","28623"
"317","2019-12-01","NHS","Ophthalmology","Cornea and Sclera","1055","2572","3627"
"318","2019-12-01","NHS","Ophthalmology","Glaucoma","1716","2982","4698"
"319","2019-12-01","NHS","Ophthalmology","Ocular Motility","800","142","942"
"320","2019-12-01","NHS","Ophthalmology","Oculoplastics","4539","2421","6960"
"321","2019-12-01","NHS","Ophthalmology","Orbit and Lacrimal","892","949","1841"
"322","2019-12-01","NHS","Ophthalmology","Vitreous Retinal","9138","201013","210151"
"323","2020-01-01","Independent Sector","Ophthalmology","Cataract","13069","606","13675"
"324","2020-01-01","Independent Sector","Ophthalmology","Cornea and Sclera","53","24","77"
"325","2020-01-01","Independent Sector","Ophthalmology","Glaucoma","24","64","88"
"326","2020-01-01","Independent Sector","Ophthalmology","Ocular Motility","4","0","4"
"327","2020-01-01","Independent Sector","Ophthalmology","Oculoplastics","154","62","216"
"328","2020-01-01","Independent Sector","Ophthalmology","Orbit and Lacrimal","39","30","69"
"329","2020-01-01","Independent Sector","Ophthalmology","Vitreous Retinal","1616","8062","9678"
"330","2020-01-01","NHS","Ophthalmology","Cataract","29780","4283","34063"
"331","2020-01-01","NHS","Ophthalmology","Cornea and Sclera","1288","2982","4270"
"332","2020-01-01","NHS","Ophthalmology","Glaucoma","2485","3558","6043"
"333","2020-01-01","NHS","Ophthalmology","Ocular Motility","1046","195","1241"
"334","2020-01-01","NHS","Ophthalmology","Oculoplastics","5578","2710","8288"
"335","2020-01-01","NHS","Ophthalmology","Orbit and Lacrimal","1111","1163","2274"
"336","2020-01-01","NHS","Ophthalmology","Vitreous Retinal","10383","242380","252763"
"337","2020-02-01","Independent Sector","Ophthalmology","Cataract","12678","528","13206"
"338","2020-02-01","Independent Sector","Ophthalmology","Cornea and Sclera","42","72","114"
"339","2020-02-01","Independent Sector","Ophthalmology","Glaucoma","13","73","86"
"340","2020-02-01","Independent Sector","Ophthalmology","Ocular Motility","7","0","7"
"341","2020-02-01","Independent Sector","Ophthalmology","Oculoplastics","185","41","226"
"342","2020-02-01","Independent Sector","Ophthalmology","Orbit and Lacrimal","29","24","53"
"343","2020-02-01","Independent Sector","Ophthalmology","Vitreous Retinal","1349","7708","9057"
"344","2020-02-01","NHS","Ophthalmology","Cataract","26991","4483","31474"
"345","2020-02-01","NHS","Ophthalmology","Cornea and Sclera","1180","2668","3848"
"346","2020-02-01","NHS","Ophthalmology","Glaucoma","2176","3397","5573"
"347","2020-02-01","NHS","Ophthalmology","Ocular Motility","976","79","1055"
"348","2020-02-01","NHS","Ophthalmology","Oculoplastics","5091","2521","7612"
"349","2020-02-01","NHS","Ophthalmology","Orbit and Lacrimal","982","1116","2098"
"350","2020-02-01","NHS","Ophthalmology","Vitreous Retinal","9638","217483","227121"
"351","2020-03-01","Independent Sector","Ophthalmology","Cataract","9483","380","9863"
"352","2020-03-01","Independent Sector","Ophthalmology","Cornea and Sclera","34","22","56"
"353","2020-03-01","Independent Sector","Ophthalmology","Glaucoma","17","45","62"
"354","2020-03-01","Independent Sector","Ophthalmology","Ocular Motility","1","0","1"
"355","2020-03-01","Independent Sector","Ophthalmology","Oculoplastics","120","29","149"
"356","2020-03-01","Independent Sector","Ophthalmology","Orbit and Lacrimal","23","12","35"
"357","2020-03-01","Independent Sector","Ophthalmology","Vitreous Retinal","1322","5982","7304"
"358","2020-03-01","NHS","Ophthalmology","Cataract","17406","2879","20285"
"359","2020-03-01","NHS","Ophthalmology","Cornea and Sclera","893","2123","3016"
"360","2020-03-01","NHS","Ophthalmology","Glaucoma","1766","2402","4168"
"361","2020-03-01","NHS","Ophthalmology","Ocular Motility","602","32","634"
"362","2020-03-01","NHS","Ophthalmology","Oculoplastics","3689","1810","5499"
"363","2020-03-01","NHS","Ophthalmology","Orbit and Lacrimal","703","682","1385"
"364","2020-03-01","NHS","Ophthalmology","Vitreous Retinal","8782","156887","165669"
"365","2020-04-01","Independent Sector","Ophthalmology","Cataract","9","5","14"
"366","2020-04-01","Independent Sector","Ophthalmology","Cornea and Sclera","5","0","5"
"367","2020-04-01","Independent Sector","Ophthalmology","Glaucoma","10","1","11"
"368","2020-04-01","Independent Sector","Ophthalmology","Oculoplastics","29","7","36"
"369","2020-04-01","Independent Sector","Ophthalmology","Orbit and Lacrimal","3","0","3"
"370","2020-04-01","Independent Sector","Ophthalmology","Vitreous Retinal","1311","1960","3271"
"371","2020-04-01","NHS","Ophthalmology","Cataract","223","125","348"
"372","2020-04-01","NHS","Ophthalmology","Cornea and Sclera","81","507","588"
"373","2020-04-01","NHS","Ophthalmology","Glaucoma","453","483","936"
"374","2020-04-01","NHS","Ophthalmology","Ocular Motility","9","6","15"
"375","2020-04-01","NHS","Ophthalmology","Oculoplastics","434","281","715"
"376","2020-04-01","NHS","Ophthalmology","Orbit and Lacrimal","70","64","134"
"377","2020-04-01","NHS","Ophthalmology","Vitreous Retinal","4482","45543","50025"
"378","2020-05-01","Independent Sector","Ophthalmology","Cataract","98","1","99"
"379","2020-05-01","Independent Sector","Ophthalmology","Cornea and Sclera","7","0","7"
"380","2020-05-01","Independent Sector","Ophthalmology","Glaucoma","7","0","7"
"381","2020-05-01","Independent Sector","Ophthalmology","Oculoplastics","46","3","49"
"382","2020-05-01","Independent Sector","Ophthalmology","Orbit and Lacrimal","6","0","6"
"383","2020-05-01","Independent Sector","Ophthalmology","Vitreous Retinal","1349","2036","3385"
"384","2020-05-01","NHS","Ophthalmology","Cataract","989","245","1234"
"385","2020-05-01","NHS","Ophthalmology","Cornea and Sclera","215","679","894"
"386","2020-05-01","NHS","Ophthalmology","Glaucoma","606","743","1349"
"387","2020-05-01","NHS","Ophthalmology","Ocular Motility","18","4","22"
"388","2020-05-01","NHS","Ophthalmology","Oculoplastics","752","487","1239"
"389","2020-05-01","NHS","Ophthalmology","Orbit and Lacrimal","92","120","212"
"390","2020-05-01","NHS","Ophthalmology","Vitreous Retinal","4871","61907","66778"
"391","2020-06-01","Independent Sector","Ophthalmology","Cataract","897","426","1323"
"392","2020-06-01","Independent Sector","Ophthalmology","Cornea and Sclera","9","1","10"
"393","2020-06-01","Independent Sector","Ophthalmology","Glaucoma","13","27","40"
"394","2020-06-01","Independent Sector","Ophthalmology","Ocular Motility","1","0","1"
"395","2020-06-01","Independent Sector","Ophthalmology","Oculoplastics","66","5","71"
"396","2020-06-01","Independent Sector","Ophthalmology","Orbit and Lacrimal","6","0","6"
"397","2020-06-01","Independent Sector","Ophthalmology","Vitreous Retinal","1654","3401","5055"
"398","2020-06-01","NHS","Ophthalmology","Cataract","5121","921","6042"
"399","2020-06-01","NHS","Ophthalmology","Cornea and Sclera","408","1423","1831"
"400","2020-06-01","NHS","Ophthalmology","Glaucoma","1162","1123","2285"
"401","2020-06-01","NHS","Ophthalmology","Ocular Motility","97","43","140"
"402","2020-06-01","NHS","Ophthalmology","Oculoplastics","1543","1022","2565"
"403","2020-06-01","NHS","Ophthalmology","Orbit and Lacrimal","175","240","415"
"404","2020-06-01","NHS","Ophthalmology","Vitreous Retinal","6500","100581","107081"
"405","2020-07-01","Independent Sector","Ophthalmology","Cataract","5707","453","6160"
"406","2020-07-01","Independent Sector","Ophthalmology","Cornea and Sclera","48","2","50"
"407","2020-07-01","Independent Sector","Ophthalmology","Glaucoma","36","22","58"
"408","2020-07-01","Independent Sector","Ophthalmology","Oculoplastics","122","4","126"
"409","2020-07-01","Independent Sector","Ophthalmology","Orbit and Lacrimal","10","2","12"
"410","2020-07-01","Independent Sector","Ophthalmology","Vitreous Retinal","1292","5633","6925"
"411","2020-07-01","NHS","Ophthalmology","Cataract","11528","1783","13311"
"412","2020-07-01","NHS","Ophthalmology","Cornea and Sclera","643","2270","2913"
"413","2020-07-01","NHS","Ophthalmology","Glaucoma","1399","1748","3147"
"414","2020-07-01","NHS","Ophthalmology","Ocular Motility","244","60","304"
"415","2020-07-01","NHS","Ophthalmology","Oculoplastics","2182","1389","3571"
"416","2020-07-01","NHS","Ophthalmology","Orbit and Lacrimal","292","368","660"
"417","2020-07-01","NHS","Ophthalmology","Vitreous Retinal","7744","131978","139722"
"418","2020-08-01","Independent Sector","Ophthalmology","Cataract","7891","585","8476"
"419","2020-08-01","Independent Sector","Ophthalmology","Cornea and Sclera","44","0","44"
"420","2020-08-01","Independent Sector","Ophthalmology","Glaucoma","34","52","86"
"421","2020-08-01","Independent Sector","Ophthalmology","Ocular Motility","2","0","2"
"422","2020-08-01","Independent Sector","Ophthalmology","Oculoplastics","143","16","159"
"423","2020-08-01","Independent Sector","Ophthalmology","Orbit and Lacrimal","33","5","38"
"424","2020-08-01","Independent Sector","Ophthalmology","Vitreous Retinal","1216","7175","8391"
"425","2020-08-01","NHS","Ophthalmology","Cataract","14282","2156","16438"
"426","2020-08-01","NHS","Ophthalmology","Cornea and Sclera","721","2304","3025"
"427","2020-08-01","NHS","Ophthalmology","Glaucoma","1178","1428","2606"
"428","2020-08-01","NHS","Ophthalmology","Ocular Motility","357","65","422"
"429","2020-08-01","NHS","Ophthalmology","Oculoplastics","2461","1432","3893"
"430","2020-08-01","NHS","Ophthalmology","Orbit and Lacrimal","402","431","833"
"431","2020-08-01","NHS","Ophthalmology","Vitreous Retinal","7297","137658","144955"
"432","2020-09-01","Independent Sector","Ophthalmology","Cataract","10249","923","11172"
"433","2020-09-01","Independent Sector","Ophthalmology","Cornea and Sclera","56","111","167"
"434","2020-09-01","Independent Sector","Ophthalmology","Glaucoma","26","77","103"
"435","2020-09-01","Independent Sector","Ophthalmology","Ocular Motility","3","0","3"
"436","2020-09-01","Independent Sector","Ophthalmology","Oculoplastics","126","24","150"
"437","2020-09-01","Independent Sector","Ophthalmology","Orbit and Lacrimal","26","9","35"
"438","2020-09-01","Independent Sector","Ophthalmology","Vitreous Retinal","1247","8818","10065"
"439","2020-09-01","NHS","Ophthalmology","Cataract","21696","3119","24815"
"440","2020-09-01","NHS","Ophthalmology","Cornea and Sclera","954","3546","4500"
"441","2020-09-01","NHS","Ophthalmology","Glaucoma","1596","1853","3449"
"442","2020-09-01","NHS","Ophthalmology","Ocular Motility","552","94","646"
"443","2020-09-01","NHS","Ophthalmology","Oculoplastics","3925","2052","5977"
"444","2020-09-01","NHS","Ophthalmology","Orbit and Lacrimal","605","606","1211"
"445","2020-09-01","NHS","Ophthalmology","Vitreous Retinal","8748","171556","180304"
"446","2020-10-01","Independent Sector","Ophthalmology","Cataract","12648","1073","13721"
"447","2020-10-01","Independent Sector","Ophthalmology","Cornea and Sclera","54","118","172"
"448","2020-10-01","Independent Sector","Ophthalmology","Glaucoma","17","61","78"
"449","2020-10-01","Independent Sector","Ophthalmology","Ocular Motility","1","0","1"
"450","2020-10-01","Independent Sector","Ophthalmology","Oculoplastics","167","34","201"
"451","2020-10-01","Independent Sector","Ophthalmology","Orbit and Lacrimal","20","8","28"
"452","2020-10-01","Independent Sector","Ophthalmology","Vitreous Retinal","1754","8869","10623"
"453","2020-10-01","NHS","Ophthalmology","Cataract","23265","3202","26467"
"454","2020-10-01","NHS","Ophthalmology","Cornea and Sclera","1078","2723","3801"
"455","2020-10-01","NHS","Ophthalmology","Glaucoma","1691","2105","3796"
"456","2020-10-01","NHS","Ophthalmology","Ocular Motility","766","60","826"
"457","2020-10-01","NHS","Ophthalmology","Oculoplastics","3930","1858","5788"
"458","2020-10-01","NHS","Ophthalmology","Orbit and Lacrimal","672","621","1293"
"459","2020-10-01","NHS","Ophthalmology","Vitreous Retinal","8606","182907","191513"
"460","2020-11-01","Independent Sector","Ophthalmology","Cataract","13551","1274","14825"
"461","2020-11-01","Independent Sector","Ophthalmology","Cornea and Sclera","52","118","170"
"462","2020-11-01","Independent Sector","Ophthalmology","Glaucoma","26","70","96"
"463","2020-11-01","Independent Sector","Ophthalmology","Ocular Motility","2","0","2"
"464","2020-11-01","Independent Sector","Ophthalmology","Oculoplastics","203","24","227"
"465","2020-11-01","Independent Sector","Ophthalmology","Orbit and Lacrimal","21","8","29"
"466","2020-11-01","Independent Sector","Ophthalmology","Vitreous Retinal","1595","8714","10309"
"467","2020-11-01","NHS","Ophthalmology","Cataract","22245","3467","25712"
"468","2020-11-01","NHS","Ophthalmology","Cornea and Sclera","1088","3360","4448"
"469","2020-11-01","NHS","Ophthalmology","Glaucoma","1882","2298","4180"
"470","2020-11-01","NHS","Ophthalmology","Ocular Motility","706","87","793"
"471","2020-11-01","NHS","Ophthalmology","Oculoplastics","3890","1948","5838"
"472","2020-11-01","NHS","Ophthalmology","Orbit and Lacrimal","718","639","1357"
"473","2020-11-01","NHS","Ophthalmology","Vitreous Retinal","8447","178911","187358"
"474","2020-12-01","Independent Sector","Ophthalmology","Cataract","10894","566","11460"
"475","2020-12-01","Independent Sector","Ophthalmology","Cornea and Sclera","67","79","146"
"476","2020-12-01","Independent Sector","Ophthalmology","Glaucoma","7","69","76"
"477","2020-12-01","Independent Sector","Ophthalmology","Ocular Motility","4","0","4"
"478","2020-12-01","Independent Sector","Ophthalmology","Oculoplastics","129","28","157"
"479","2020-12-01","Independent Sector","Ophthalmology","Orbit and Lacrimal","6","8","14"
"480","2020-12-01","Independent Sector","Ophthalmology","Vitreous Retinal","1746","7953","9699"
"481","2020-12-01","NHS","Ophthalmology","Cataract","18660","2952","21612"
"482","2020-12-01","NHS","Ophthalmology","Cornea and Sclera","890","2823","3713"
"483","2020-12-01","NHS","Ophthalmology","Glaucoma","1566","2140","3706"
"484","2020-12-01","NHS","Ophthalmology","Ocular Motility","580","69","649"
"485","2020-12-01","NHS","Ophthalmology","Oculoplastics","3298","1829","5127"
"486","2020-12-01","NHS","Ophthalmology","Orbit and Lacrimal","567","532","1099"
"487","2020-12-01","NHS","Ophthalmology","Vitreous Retinal","8161","169982","178143"
"488","2021-01-01","Independent Sector","Ophthalmology","Cataract","13044","1022","14066"
"489","2021-01-01","Independent Sector","Ophthalmology","Cornea and Sclera","60","107","167"
"490","2021-01-01","Independent Sector","Ophthalmology","Glaucoma","41","56","97"
"491","2021-01-01","Independent Sector","Ophthalmology","Ocular Motility","4","0","4"
"492","2021-01-01","Independent Sector","Ophthalmology","Oculoplastics","142","39","181"
"493","2021-01-01","Independent Sector","Ophthalmology","Orbit and Lacrimal","19","4","23"
"494","2021-01-01","Independent Sector","Ophthalmology","Vitreous Retinal","1711","8090","9801"
"495","2021-01-01","NHS","Ophthalmology","Cataract","9299","2556","11855"
"496","2021-01-01","NHS","Ophthalmology","Cornea and Sclera","660","2140","2800"
"497","2021-01-01","NHS","Ophthalmology","Glaucoma","1475","1975","3450"
"498","2021-01-01","NHS","Ophthalmology","Ocular Motility","240","62","302"
"499","2021-01-01","NHS","Ophthalmology","Oculoplastics","2173","1373","3546"
"500","2021-01-01","NHS","Ophthalmology","Orbit and Lacrimal","332","419","751"
"501","2021-01-01","NHS","Ophthalmology","Vitreous Retinal","7476","155583","163059"
"502","2021-02-01","Independent Sector","Ophthalmology","Cataract","14796","629","15425"
"503","2021-02-01","Independent Sector","Ophthalmology","Cornea and Sclera","41","92","133"
"504","2021-02-01","Independent Sector","Ophthalmology","Glaucoma","48","72","120"
"505","2021-02-01","Independent Sector","Ophthalmology","Ocular Motility","11","0","11"
"506","2021-02-01","Independent Sector","Ophthalmology","Oculoplastics","243","21","264"
"507","2021-02-01","Independent Sector","Ophthalmology","Orbit and Lacrimal","26","6","32"
"508","2021-02-01","Independent Sector","Ophthalmology","Vitreous Retinal","1779","8694","10473"
"509","2021-02-01","NHS","Ophthalmology","Cataract","9182","2808","11990"
"510","2021-02-01","NHS","Ophthalmology","Cornea and Sclera","696","2096","2792"
"511","2021-02-01","NHS","Ophthalmology","Glaucoma","1489","2125","3614"
"512","2021-02-01","NHS","Ophthalmology","Ocular Motility","189","50","239"
"513","2021-02-01","NHS","Ophthalmology","Oculoplastics","2214","1461","3675"
"514","2021-02-01","NHS","Ophthalmology","Orbit and Lacrimal","267","541","808"
"515","2021-02-01","NHS","Ophthalmology","Vitreous Retinal","7373","167662","175035"
"516","2021-03-01","Independent Sector","Ophthalmology","Cataract","17560","1671","19231"
"517","2021-03-01","Independent Sector","Ophthalmology","Cornea and Sclera","71","159","230"
"518","2021-03-01","Independent Sector","Ophthalmology","Glaucoma","38","46","84"
"519","2021-03-01","Independent Sector","Ophthalmology","Ocular Motility","28","0","28"
"520","2021-03-01","Independent Sector","Ophthalmology","Oculoplastics","260","26","286"
"521","2021-03-01","Independent Sector","Ophthalmology","Orbit and Lacrimal","53","13","66"
"522","2021-03-01","Independent Sector","Ophthalmology","Vitreous Retinal","1852","10818","12670"
"523","2021-03-01","NHS","Ophthalmology","Cataract","18047","3348","21395"
"524","2021-03-01","NHS","Ophthalmology","Cornea and Sclera","1003","3165","4168"
"525","2021-03-01","NHS","Ophthalmology","Glaucoma","1948","2639","4587"
"526","2021-03-01","NHS","Ophthalmology","Ocular Motility","502","50","552"
"527","2021-03-01","NHS","Ophthalmology","Oculoplastics","3691","2093","5784"
"528","2021-03-01","NHS","Ophthalmology","Orbit and Lacrimal","537","663","1200"
"529","2021-03-01","NHS","Ophthalmology","Vitreous Retinal","9499","211380","220879"
"530","2021-04-01","Independent Sector","Ophthalmology","Cataract","16491","931","17422"
"531","2021-04-01","Independent Sector","Ophthalmology","Cornea and Sclera","59","139","198"
"532","2021-04-01","Independent Sector","Ophthalmology","Glaucoma","25","57","82"
"533","2021-04-01","Independent Sector","Ophthalmology","Ocular Motility","12","10","22"
"534","2021-04-01","Independent Sector","Ophthalmology","Oculoplastics","161","111","272"
"535","2021-04-01","Independent Sector","Ophthalmology","Orbit and Lacrimal","14","30","44"
"536","2021-04-01","Independent Sector","Ophthalmology","Vitreous Retinal","1582","13701","15283"
"537","2021-04-01","NHS","Ophthalmology","Cataract","20003","3229","23232"
"538","2021-04-01","NHS","Ophthalmology","Cornea and Sclera","895","2845","3740"
"539","2021-04-01","NHS","Ophthalmology","Glaucoma","1770","2410","4180"
"540","2021-04-01","NHS","Ophthalmology","Ocular Motility","649","49","698"
"541","2021-04-01","NHS","Ophthalmology","Oculoplastics","3516","2042","5558"
"542","2021-04-01","NHS","Ophthalmology","Orbit and Lacrimal","626","704","1330"
"543","2021-04-01","NHS","Ophthalmology","Vitreous Retinal","8727","199970","208697"
"544","2021-05-01","Independent Sector","Ophthalmology","Cataract","17318","960","18278"
"545","2021-05-01","Independent Sector","Ophthalmology","Cornea and Sclera","67","144","211"
"546","2021-05-01","Independent Sector","Ophthalmology","Glaucoma","34","47","81"
"547","2021-05-01","Independent Sector","Ophthalmology","Ocular Motility","9","9","18"
"548","2021-05-01","Independent Sector","Ophthalmology","Oculoplastics","124","75","199"
"549","2021-05-01","Independent Sector","Ophthalmology","Orbit and Lacrimal","7","23","30"
"550","2021-05-01","Independent Sector","Ophthalmology","Vitreous Retinal","1602","12627","14229"
"551","2021-05-01","NHS","Ophthalmology","Cataract","22232","3112","25344"
"552","2021-05-01","NHS","Ophthalmology","Cornea and Sclera","1050","2939","3989"
"553","2021-05-01","NHS","Ophthalmology","Glaucoma","1701","2603","4304"
"554","2021-05-01","NHS","Ophthalmology","Ocular Motility","754","71","825"
"555","2021-05-01","NHS","Ophthalmology","Oculoplastics","4005","1922","5927"
"556","2021-05-01","NHS","Ophthalmology","Orbit and Lacrimal","722","614","1336"
"557","2021-05-01","NHS","Ophthalmology","Vitreous Retinal","8507","196853","205360"
"558","2021-06-01","Independent Sector","Ophthalmology","Cataract","19295","1072","20367"
"559","2021-06-01","Independent Sector","Ophthalmology","Cornea and Sclera","77","125","202"
"560","2021-06-01","Independent Sector","Ophthalmology","Glaucoma","42","69","111"
"561","2021-06-01","Independent Sector","Ophthalmology","Ocular Motility","7","16","23"
"562","2021-06-01","Independent Sector","Ophthalmology","Oculoplastics","144","86","230"
"563","2021-06-01","Independent Sector","Ophthalmology","Orbit and Lacrimal","16","32","48"
"564","2021-06-01","Independent Sector","Ophthalmology","Vitreous Retinal","1854","14181","16035"
"565","2021-06-01","NHS","Ophthalmology","Cataract","25674","3666","29340"
"566","2021-06-01","NHS","Ophthalmology","Cornea and Sclera","1168","3347","4515"
"567","2021-06-01","NHS","Ophthalmology","Glaucoma","1989","3072","5061"
"568","2021-06-01","NHS","Ophthalmology","Ocular Motility","922","88","1010"
"569","2021-06-01","NHS","Ophthalmology","Oculoplastics","4569","2167","6736"
"570","2021-06-01","NHS","Ophthalmology","Orbit and Lacrimal","820","837","1657"
"571","2021-06-01","NHS","Ophthalmology","Vitreous Retinal","9692","218139","227831"
"572","2021-07-01","Independent Sector","Ophthalmology","Cataract","19555","1069","20624"
"573","2021-07-01","Independent Sector","Ophthalmology","Cornea and Sclera","83","141","224"
"574","2021-07-01","Independent Sector","Ophthalmology","Glaucoma","23","53","76"
"575","2021-07-01","Independent Sector","Ophthalmology","Ocular Motility","10","10","20"
"576","2021-07-01","Independent Sector","Ophthalmology","Oculoplastics","149","92","241"
"577","2021-07-01","Independent Sector","Ophthalmology","Orbit and Lacrimal","12","27","39"
"578","2021-07-01","Independent Sector","Ophthalmology","Vitreous Retinal","1794","13856","15650"
"579","2021-07-01","NHS","Ophthalmology","Cataract","24189","3451","27640"
"580","2021-07-01","NHS","Ophthalmology","Cornea and Sclera","1164","3877","5041"
"581","2021-07-01","NHS","Ophthalmology","Glaucoma","1738","2972","4710"
"582","2021-07-01","NHS","Ophthalmology","Ocular Motility","822","95","917"
"583","2021-07-01","NHS","Ophthalmology","Oculoplastics","4378","2057","6435"
"584","2021-07-01","NHS","Ophthalmology","Orbit and Lacrimal","755","768","1523"
"585","2021-07-01","NHS","Ophthalmology","Vitreous Retinal","9154","207446","216600"
"586","2021-08-01","Independent Sector","Ophthalmology","Cataract","17559","861","18420"
"587","2021-08-01","Independent Sector","Ophthalmology","Cornea and Sclera","86","120","206"
"588","2021-08-01","Independent Sector","Ophthalmology","Glaucoma","25","95","120"
"589","2021-08-01","Independent Sector","Ophthalmology","Ocular Motility","4","0","4"
"590","2021-08-01","Independent Sector","Ophthalmology","Oculoplastics","92","61","153"
"591","2021-08-01","Independent Sector","Ophthalmology","Orbit and Lacrimal","25","5","30"
"592","2021-08-01","Independent Sector","Ophthalmology","Vitreous Retinal","1852","10586","12438"
"593","2021-08-01","NHS","Ophthalmology","Cataract","21650","3495","25145"
"594","2021-08-01","NHS","Ophthalmology","Cornea and Sclera","946","3955","4901"
"595","2021-08-01","NHS","Ophthalmology","Glaucoma","1554","2862","4416"
"596","2021-08-01","NHS","Ophthalmology","Ocular Motility","755","75","830"
"597","2021-08-01","NHS","Ophthalmology","Oculoplastics","3802","1906","5708"
"598","2021-08-01","NHS","Ophthalmology","Orbit and Lacrimal","691","587","1278"
"599","2021-08-01","NHS","Ophthalmology","Vitreous Retinal","8399","194976","203375"
"600","2021-09-01","Independent Sector","Ophthalmology","Cataract","19014","677","19691"
"601","2021-09-01","Independent Sector","Ophthalmology","Cornea and Sclera","87","183","270"
"602","2021-09-01","Independent Sector","Ophthalmology","Glaucoma","29","53","82"
"603","2021-09-01","Independent Sector","Ophthalmology","Ocular Motility","2","0","2"
"604","2021-09-01","Independent Sector","Ophthalmology","Oculoplastics","142","30","172"
"605","2021-09-01","Independent Sector","Ophthalmology","Orbit and Lacrimal","19","11","30"
"606","2021-09-01","Independent Sector","Ophthalmology","Vitreous Retinal","1822","11822","13644"
"607","2021-09-01","NHS","Ophthalmology","Cataract","24295","3710","28005"
"608","2021-09-01","NHS","Ophthalmology","Cornea and Sclera","1084","5040","6124"
"609","2021-09-01","NHS","Ophthalmology","Glaucoma","1794","3071","4865"
"610","2021-09-01","NHS","Ophthalmology","Ocular Motility","847","71","918"
"611","2021-09-01","NHS","Ophthalmology","Oculoplastics","4234","2193","6427"
"612","2021-09-01","NHS","Ophthalmology","Orbit and Lacrimal","740","728","1468"
"613","2021-09-01","NHS","Ophthalmology","Vitreous Retinal","9560","217803","227363"
"614","2021-10-01","Independent Sector","Ophthalmology","Cataract","20321","902","21223"
"615","2021-10-01","Independent Sector","Ophthalmology","Cornea and Sclera","96","182","278"
"616","2021-10-01","Independent Sector","Ophthalmology","Glaucoma","27","100","127"
"617","2021-10-01","Independent Sector","Ophthalmology","Ocular Motility","9","0","9"
"618","2021-10-01","Independent Sector","Ophthalmology","Oculoplastics","155","39","194"
"619","2021-10-01","Independent Sector","Ophthalmology","Orbit and Lacrimal","20","9","29"
"620","2021-10-01","Independent Sector","Ophthalmology","Vitreous Retinal","1492","12016","13508"
"621","2021-10-01","NHS","Ophthalmology","Cataract","22962","3594","26556"
"622","2021-10-01","NHS","Ophthalmology","Cornea and Sclera","1069","4896","5965"
"623","2021-10-01","NHS","Ophthalmology","Glaucoma","1692","2782","4474"
"624","2021-10-01","NHS","Ophthalmology","Ocular Motility","834","58","892"
"625","2021-10-01","NHS","Ophthalmology","Oculoplastics","3963","1954","5917"
"626","2021-10-01","NHS","Ophthalmology","Orbit and Lacrimal","750","700","1450"
"627","2021-10-01","NHS","Ophthalmology","Vitreous Retinal","9291","207642","216933"
"628","2021-11-01","Independent Sector","Ophthalmology","Cataract","21449","784","22233"
"629","2021-11-01","Independent Sector","Ophthalmology","Cornea and Sclera","119","196","315"
"630","2021-11-01","Independent Sector","Ophthalmology","Glaucoma","16","96","112"
"631","2021-11-01","Independent Sector","Ophthalmology","Ocular Motility","7","0","7"
"632","2021-11-01","Independent Sector","Ophthalmology","Oculoplastics","133","29","162"
"633","2021-11-01","Independent Sector","Ophthalmology","Orbit and Lacrimal","15","9","24"
"634","2021-11-01","Independent Sector","Ophthalmology","Vitreous Retinal","1536","12833","14369"
"635","2021-11-01","NHS","Ophthalmology","Cataract","25118","3749","28867"
"636","2021-11-01","NHS","Ophthalmology","Cornea and Sclera","1185","5106","6291"
"637","2021-11-01","NHS","Ophthalmology","Glaucoma","1986","3432","5418"
"638","2021-11-01","NHS","Ophthalmology","Ocular Motility","903","100","1003"
"639","2021-11-01","NHS","Ophthalmology","Oculoplastics","4435","2354","6789"
"640","2021-11-01","NHS","Ophthalmology","Orbit and Lacrimal","841","918","1759"
"641","2021-11-01","NHS","Ophthalmology","Vitreous Retinal","9862","225588","235450"
"642","2021-12-01","Independent Sector","Ophthalmology","Cataract","17024","749","17773"
"643","2021-12-01","Independent Sector","Ophthalmology","Cornea and Sclera","110","166","276"
"644","2021-12-01","Independent Sector","Ophthalmology","Glaucoma","27","54","81"
"645","2021-12-01","Independent Sector","Ophthalmology","Ocular Motility","3","0","3"
"646","2021-12-01","Independent Sector","Ophthalmology","Oculoplastics","113","21","134"
"647","2021-12-01","Independent Sector","Ophthalmology","Orbit and Lacrimal","18","10","28"
"648","2021-12-01","Independent Sector","Ophthalmology","Vitreous Retinal","1652","11581","13233"
"649","2021-12-01","NHS","Ophthalmology","Cataract","18954","2970","21924"
"650","2021-12-01","NHS","Ophthalmology","Cornea and Sclera","990","4361","5351"
"651","2021-12-01","NHS","Ophthalmology","Glaucoma","1556","2829","4385"
"652","2021-12-01","NHS","Ophthalmology","Ocular Motility","664","60","724"
"653","2021-12-01","NHS","Ophthalmology","Oculoplastics","3730","2038","5768"
"654","2021-12-01","NHS","Ophthalmology","Orbit and Lacrimal","598","745","1343"
"655","2021-12-01","NHS","Ophthalmology","Vitreous Retinal","8843","187992","196835"
"656","2022-01-01","Independent Sector","Ophthalmology","Cataract","20197","670","20867"
"657","2022-01-01","Independent Sector","Ophthalmology","Cornea and Sclera","97","185","282"
"658","2022-01-01","Independent Sector","Ophthalmology","Glaucoma","17","68","85"
"659","2022-01-01","Independent Sector","Ophthalmology","Ocular Motility","3","0","3"
"660","2022-01-01","Independent Sector","Ophthalmology","Oculoplastics","124","29","153"
"661","2022-01-01","Independent Sector","Ophthalmology","Orbit and Lacrimal","15","8","23"
"662","2022-01-01","Independent Sector","Ophthalmology","Vitreous Retinal","1479","12790","14269"
"663","2022-01-01","NHS","Ophthalmology","Cataract","19925","3214","23139"
"664","2022-01-01","NHS","Ophthalmology","Cornea and Sclera","1041","6000","7041"
"665","2022-01-01","NHS","Ophthalmology","Glaucoma","1688","2978","4666"
"666","2022-01-01","NHS","Ophthalmology","Ocular Motility","677","65","742"
"667","2022-01-01","NHS","Ophthalmology","Oculoplastics","3842","2077","5919"
"668","2022-01-01","NHS","Ophthalmology","Orbit and Lacrimal","695","782","1477"
"669","2022-01-01","NHS","Ophthalmology","Vitreous Retinal","9262","204701","213963"
"670","2022-02-01","Independent Sector","Ophthalmology","Cataract","22079","833","22912"
"671","2022-02-01","Independent Sector","Ophthalmology","Cornea and Sclera","90","246","336"
"672","2022-02-01","Independent Sector","Ophthalmology","Glaucoma","31","101","132"
"673","2022-02-01","Independent Sector","Ophthalmology","Ocular Motility","8","0","8"
"674","2022-02-01","Independent Sector","Ophthalmology","Oculoplastics","136","22","158"
"675","2022-02-01","Independent Sector","Ophthalmology","Orbit and Lacrimal","16","11","27"
"676","2022-02-01","Independent Sector","Ophthalmology","Vitreous Retinal","1422","12530","13952"
"677","2022-02-01","NHS","Ophthalmology","Cataract","20899","3229","24128"
"678","2022-02-01","NHS","Ophthalmology","Cornea and Sclera","1031","5249","6280"
"679","2022-02-01","NHS","Ophthalmology","Glaucoma","1710","2998","4708"
"680","2022-02-01","NHS","Ophthalmology","Ocular Motility","769","60","829"
"681","2022-02-01","NHS","Ophthalmology","Oculoplastics","4007","2169","6176"
"682","2022-02-01","NHS","Ophthalmology","Orbit and Lacrimal","742","775","1517"
"683","2022-02-01","NHS","Ophthalmology","Vitreous Retinal","8702","204998","213700"
"684","2022-03-01","Independent Sector","Ophthalmology","Cataract","24597","905","25502"
"685","2022-03-01","Independent Sector","Ophthalmology","Cornea and Sclera","107","257","364"
"686","2022-03-01","Independent Sector","Ophthalmology","Glaucoma","20","115","135"
"687","2022-03-01","Independent Sector","Ophthalmology","Ocular Motility","6","0","6"
"688","2022-03-01","Independent Sector","Ophthalmology","Oculoplastics","134","57","191"
"689","2022-03-01","Independent Sector","Ophthalmology","Orbit and Lacrimal","25","18","43"
"690","2022-03-01","Independent Sector","Ophthalmology","Vitreous Retinal","1734","15125","16859"
"691","2022-03-01","NHS","Ophthalmology","Cataract","23706","3810","27516"
"692","2022-03-01","NHS","Ophthalmology","Cornea and Sclera","1186","5752","6938"
"693","2022-03-01","NHS","Ophthalmology","Glaucoma","1949","3314","5263"
"694","2022-03-01","NHS","Ophthalmology","Ocular Motility","952","70","1022"
"695","2022-03-01","NHS","Ophthalmology","Oculoplastics","4556","2376","6932"
"696","2022-03-01","NHS","Ophthalmology","Orbit and Lacrimal","808","894","1702"
"697","2022-03-01","NHS","Ophthalmology","Vitreous Retinal","10451","230769","241220"
"698","2022-04-01","Independent Sector","Ophthalmology","Cataract","21021","878","21899"
"699","2022-04-01","Independent Sector","Ophthalmology","Cornea and Sclera","84","192","276"
"700","2022-04-01","Independent Sector","Ophthalmology","Glaucoma","30","92","122"
"701","2022-04-01","Independent Sector","Ophthalmology","Ocular Motility","3","0","3"
"702","2022-04-01","Independent Sector","Ophthalmology","Oculoplastics","120","34","154"
"703","2022-04-01","Independent Sector","Ophthalmology","Orbit and Lacrimal","15","9","24"
"704","2022-04-01","Independent Sector","Ophthalmology","Vitreous Retinal","1418","14337","15755"
"705","2022-04-01","NHS","Ophthalmology","Cataract","18721","2647","21368"
"706","2022-04-01","NHS","Ophthalmology","Cornea and Sclera","834","5459","6293"
"707","2022-04-01","NHS","Ophthalmology","Glaucoma","1616","2910","4526"
"708","2022-04-01","NHS","Ophthalmology","Ocular Motility","778","50","828"
"709","2022-04-01","NHS","Ophthalmology","Oculoplastics","3750","1884","5634"
"710","2022-04-01","NHS","Ophthalmology","Orbit and Lacrimal","737","711","1448"
"711","2022-04-01","NHS","Ophthalmology","Vitreous Retinal","9661","199383","209044"
"712","2022-05-01","Independent Sector","Ophthalmology","Cataract","24712","1026","25738"
"713","2022-05-01","Independent Sector","Ophthalmology","Cornea and Sclera","95","197","292"
"714","2022-05-01","Independent Sector","Ophthalmology","Glaucoma","20","81","101"
"715","2022-05-01","Independent Sector","Ophthalmology","Ocular Motility","8","0","8"
"716","2022-05-01","Independent Sector","Ophthalmology","Oculoplastics","143","54","197"
"717","2022-05-01","Independent Sector","Ophthalmology","Orbit and Lacrimal","24","17","41"
"718","2022-05-01","Independent Sector","Ophthalmology","Vitreous Retinal","1328","15443","16771"
"719","2022-05-01","NHS","Ophthalmology","Cataract","22424","3273","25697"
"720","2022-05-01","NHS","Ophthalmology","Cornea and Sclera","1089","5736","6825"
"721","2022-05-01","NHS","Ophthalmology","Glaucoma","2023","3464","5487"
"722","2022-05-01","NHS","Ophthalmology","Ocular Motility","864","70","934"
"723","2022-05-01","NHS","Ophthalmology","Oculoplastics","4676","2258","6934"
"724","2022-05-01","NHS","Ophthalmology","Orbit and Lacrimal","859","796","1655"
"725","2022-05-01","NHS","Ophthalmology","Vitreous Retinal","10943","229364","240307"
"726","2022-06-01","Independent Sector","Ophthalmology","Cataract","24909","981","25890"
"727","2022-06-01","Independent Sector","Ophthalmology","Cornea and Sclera","95","173","268"
"728","2022-06-01","Independent Sector","Ophthalmology","Glaucoma","19","101","120"
"729","2022-06-01","Independent Sector","Ophthalmology","Ocular Motility","7","0","7"
"730","2022-06-01","Independent Sector","Ophthalmology","Oculoplastics","157","34","191"
"731","2022-06-01","Independent Sector","Ophthalmology","Orbit and Lacrimal","19","10","29"
"732","2022-06-01","Independent Sector","Ophthalmology","Vitreous Retinal","1871","14759","16630"
"733","2022-06-01","NHS","Ophthalmology","Cataract","20799","3167","23966"
"734","2022-06-01","NHS","Ophthalmology","Cornea and Sclera","996","6373","7369"
"735","2022-06-01","NHS","Ophthalmology","Glaucoma","1819","3142","4961"
"736","2022-06-01","NHS","Ophthalmology","Ocular Motility","888","70","958"
"737","2022-06-01","NHS","Ophthalmology","Oculoplastics","4080","2040","6120"
"738","2022-06-01","NHS","Ophthalmology","Orbit and Lacrimal","770","806","1576"
"739","2022-06-01","NHS","Ophthalmology","Vitreous Retinal","10421","211566","221987"
"740","2022-07-01","Independent Sector","Ophthalmology","Cataract","25314","1244","26558"
"741","2022-07-01","Independent Sector","Ophthalmology","Cornea and Sclera","106","160","266"
"742","2022-07-01","Independent Sector","Ophthalmology","Glaucoma","23","77","100"
"743","2022-07-01","Independent Sector","Ophthalmology","Ocular Motility","6","0","6"
"744","2022-07-01","Independent Sector","Ophthalmology","Oculoplastics","125","34","159"
"745","2022-07-01","Independent Sector","Ophthalmology","Orbit and Lacrimal","15","17","32"
"746","2022-07-01","Independent Sector","Ophthalmology","Vitreous Retinal","1228","15573","16801"
"747","2022-07-01","NHS","Ophthalmology","Cataract","20751","3138","23889"
"748","2022-07-01","NHS","Ophthalmology","Cornea and Sclera","964","7176","8140"
"749","2022-07-01","NHS","Ophthalmology","Glaucoma","1851","3214","5065"
"750","2022-07-01","NHS","Ophthalmology","Ocular Motility","779","89","868"
"751","2022-07-01","NHS","Ophthalmology","Oculoplastics","4149","1967","6116"
"752","2022-07-01","NHS","Ophthalmology","Orbit and Lacrimal","741","713","1454"
"753","2022-07-01","NHS","Ophthalmology","Vitreous Retinal","10421","210047","220468"
"754","2022-08-01","Independent Sector","Ophthalmology","Cataract","25987","1007","26994"
"755","2022-08-01","Independent Sector","Ophthalmology","Cornea and Sclera","103","189","292"
"756","2022-08-01","Independent Sector","Ophthalmology","Glaucoma","14","94","108"
"757","2022-08-01","Independent Sector","Ophthalmology","Ocular Motility","8","0","8"
"758","2022-08-01","Independent Sector","Ophthalmology","Oculoplastics","206","56","262"
"759","2022-08-01","Independent Sector","Ophthalmology","Orbit and Lacrimal","31","13","44"
"760","2022-08-01","Independent Sector","Ophthalmology","Vitreous Retinal","1541","16752","18293"
"761","2022-08-01","NHS","Ophthalmology","Cataract","21678","2978","24656"
"762","2022-08-01","NHS","Ophthalmology","Cornea and Sclera","1013","7255","8268"
"763","2022-08-01","NHS","Ophthalmology","Glaucoma","1739","3086","4825"
"764","2022-08-01","NHS","Ophthalmology","Ocular Motility","816","63","879"
"765","2022-08-01","NHS","Ophthalmology","Oculoplastics","4389","2157","6546"
"766","2022-08-01","NHS","Ophthalmology","Orbit and Lacrimal","761","803","1564"
"767","2022-08-01","NHS","Ophthalmology","Vitreous Retinal","10794","221451","232245"
"768","2022-09-01","Independent Sector","Ophthalmology","Cataract","29094","1278","30372"
"769","2022-09-01","Independent Sector","Ophthalmology","Cornea and Sclera","102","177","279"
"770","2022-09-01","Independent Sector","Ophthalmology","Glaucoma","22","95","117"
"771","2022-09-01","Independent Sector","Ophthalmology","Ocular Motility","9","0","9"
"772","2022-09-01","Independent Sector","Ophthalmology","Oculoplastics","215","27","242"
"773","2022-09-01","Independent Sector","Ophthalmology","Orbit and Lacrimal","21","25","46"
"774","2022-09-01","Independent Sector","Ophthalmology","Vitreous Retinal","1853","16813","18666"
"775","2022-09-01","NHS","Ophthalmology","Cataract","21633","3414","25047"
"776","2022-09-01","NHS","Ophthalmology","Cornea and Sclera","1043","7867","8910"
"777","2022-09-01","NHS","Ophthalmology","Glaucoma","1863","3269","5132"
"778","2022-09-01","NHS","Ophthalmology","Ocular Motility","830","52","882"
"779","2022-09-01","NHS","Ophthalmology","Oculoplastics","4422","2066","6488"
"780","2022-09-01","NHS","Ophthalmology","Orbit and Lacrimal","804","756","1560"
"781","2022-09-01","NHS","Ophthalmology","Vitreous Retinal","10926","221338","232264"
"782","2022-10-01","Independent Sector","Ophthalmology","Cataract","30676","1308","31984"
"783","2022-10-01","Independent Sector","Ophthalmology","Cornea and Sclera","109","192","301"
"784","2022-10-01","Independent Sector","Ophthalmology","Glaucoma","19","57","76"
"785","2022-10-01","Independent Sector","Ophthalmology","Ocular Motility","4","0","4"
"786","2022-10-01","Independent Sector","Ophthalmology","Oculoplastics","192","36","228"
"787","2022-10-01","Independent Sector","Ophthalmology","Orbit and Lacrimal","26","8","34"
"788","2022-10-01","Independent Sector","Ophthalmology","Vitreous Retinal","1792","17077","18869"
"789","2022-10-01","NHS","Ophthalmology","Cataract","21627","3390","25017"
"790","2022-10-01","NHS","Ophthalmology","Cornea and Sclera","1001","8107","9108"
"791","2022-10-01","NHS","Ophthalmology","Glaucoma","1705","3255","4960"
"792","2022-10-01","NHS","Ophthalmology","Ocular Motility","947","67","1014"
"793","2022-10-01","NHS","Ophthalmology","Oculoplastics","4506","2083","6589"
"794","2022-10-01","NHS","Ophthalmology","Orbit and Lacrimal","790","762","1552"
"795","2022-10-01","NHS","Ophthalmology","Vitreous Retinal","10972","223830","234802"